#Translations for: Перевод имен поставляемых метаданных

ApdexExport_1_0_0_2=ApdexExport_1_0_0_2
ApdexExport_1_0_0_3=ApdexExport_1_0_0_3
ApdexExport_1_0_0_4=ApdexExport_1_0_0_4
ApplicationExtensionsCompatibility_1_0_0_1=ApplicationExtensionsCompatibility_1_0_0_1
ApplicationExtensionsControl_1_0_1_1=ApplicationExtensionsControl_1_0_1_1
ApplicationExtensionsManagement_1_0_1_1=ApplicationExtensionsManagement_1_0_1_1
ApplicationExtensionsManagement_1_0_1_2=ApplicationExtensionsManagement_1_0_1_2
ApplicationExtensionsManifest_1_0_0_1=ApplicationExtensionsManifest_1_0_0_1
ApplicationExtensionsManifest_1_0_0_2=ApplicationExtensionsManifest_1_0_0_2
ApplicationExtensionsPermissions_1_0_0_1=ApplicationExtensionsPermissions_1_0_0_1
ApplicationPermissions_1_0_0_1=ApplicationPermissions_1_0_0_1
ApplicationPermissions_1_0_0_2=ApplicationPermissions_1_0_0_2
BotFatherВконтакте=BotFatherVKontakte
COMАутентификацияОперационнойСистемы=COMOperatingSystemAuthentication
COMВариантРаботыИнформационнойБазы=COMInfobaseOperatingMode
COMИмяИнформационнойБазыНаСервере1СПредприятия=COM1CEnterpriseServerSideInfobaseName
COMИмяПользователя=COMUsername
COMИмяСервера1СПредприятия=COM1CEnterpriseServerName
COMКаталогИнформационнойБазы=COMInfobaseDirectory
COMПарольПользователя=COMUserPassword
DataArtefacts_Files_1_0_0_1=DataArtefacts_Files_1_0_0_1
DataArtefacts_ServiceUsers_1_0_0_1=DataArtefacts_ServiceUsers_1_0_0_1
DataDump_1_0_2_1=DataDump_1_0_2_1
EMAILМаксимальныйДопустимыйРазмерСообщения=EMAILMaxMessageSize
EmailПользователя=UserEmail
EMAILСжиматьФайлИсходящегоСообщения=EMAILCompressOutgoingMessageFile
EMAILТранслитерироватьИменаФайловСообщенийОбмена=EMAILTransliterateExchangeMessageFileNames
EMAILУчетнаяЗапись=EMAIL_Account
EnterpriseData_1_2_3=EnterpriseData_1_2_3
EnterpriseData_1_3_20=EnterpriseData_1_3_20
EnterpriseData_1_4_20=EnterpriseData_1_4_20
EnterpriseData_1_5_22=EnterpriseData_1_5_22
EnterpriseData_1_6_23=EnterpriseData_1_6_23
EnterpriseData_1_7_8=EnterpriseData_1_7_8
EnterpriseData_1_8_6=EnterpriseData_1_8_6
EnterpriseDataExchange_1_0_1_1=EnterpriseDataExchange_1_0_1_1
EnterpriseDataUpload_1_0_1_1=EnterpriseDataUpload_1_0_1_1
Exchange_2_0_1_6=Exchange_2_0_1_6
Exchange_3_0_1_1=Exchange_3_0_1_1
FILEКаталогОбменаИнформацией=FILEDataExchangeDirectory
FILEСжиматьФайлИсходящегоСообщения=FILECompressOutgoingMessageFile
FILEТранслитерироватьИменаФайловСообщенийОбмена=FILETransliterateExchangeMessageFileNames
FTPКаталог=FTPDirectory
FTPЛогин=FTPUsername
FTPПассивноеСоединение=FTPPassiveConnection
FTPПорт=FTPPort
FTPСервер=FTPServer
FTPСжиматьФайлИсходящегоСообщения=FTPCompressOutgoingMessageFile
FTPСоединениеМаксимальныйДопустимыйРазмерСообщения=FTPConnectionMaxMessageSize
FTPСоединениеПароль=FTPConnectionPassword
FTPСоединениеПассивноеСоединение=FTPConnectionPassiveConnection
FTPСоединениеПользователь=FTPConnectionUser
FTPСоединениеПорт=FTPConnectionPort
FTPСоединениеПуть=FTPConnectionPath
FTPТранслитерироватьИменаФайловСообщенийОбмена=FTPTransliterateExchangeMessageFileNames
GoogleПереводчик=GoogleTranslate
HTMLСКартинками=HTMLWithPictures
Linux_x86_64_Chrome=Linux_x86_64_Chrome
Linux_x86_64_Firefox=Linux_x86_64_Firefox
Linux_x86_Chrome=Linux_x86_Chrome
Linux_x86_Firefox=Linux_x86_Firefox
MacOS_x86_64_Safari=MacOS_x86_64_Safari
RemoteAdministrationOfExchange_2_0_1_6=RemoteAdministrationOfExchange_2_0_1_6
RemoteAdministrationOfExchange_2_1_6_1=RemoteAdministrationOfExchange_2_1_6_1
RemoteAdministrationOfExchange_2_4_5_1=RemoteAdministrationOfExchange_2_4_5_1
URLВебСервиса=WebServiceURL
Windows_x86_64_MSIE=Windows_x86_64_MSIE
Windows_x86_Chrome=Windows_x86_Chrome
Windows_x86_Firefox=Windows_x86_Firefox
Windows_x86_MSIE=Windows_x86_MSIE
WSURLВебСервиса=WSWebServiceURL
WSЗапомнитьПароль=WSRememberPassword
WSИмяПользователя=WSUsername
WSИспользоватьПередачуБольшогоОбъемаДанных=WSUseLargeVolumeDataTransfer
WSПароль=WSPassword
WSПассивныйРежим=WSPassiveMode
АбонентКакСвязаться=HowToContactSubscriber
АбонентКонтакт=SubscriberContact
АбонентПредставление=SubscriberPresentation
АвтоисправлениеПроблемы=AutoCorrectIssues
АвтоматическийЭкспортЗамеровПроизводительности=AutomaticPerformanceMeasurementsExport
АвтоматическиНастраиватьРазрешенияВПрофиляхБезопасности=AutomaticallyConfigurePermissionsInSecurityProfiles
АвтоматическоеИзвлечениеТекстов=AutoTextExtraction
АвтономнаяРабота=StandaloneMode
АвтономнаяРаботаВМоделиСервиса=StandaloneModeSaaS
АвтономнаяРаботаПроверитьВозможностьЗаписиОбщихДанных=StandaloneModeCheckCanWriteCommonData
АвтономнаяРаботаПроверитьВозможностьЗаписиОбщихДанныхДокумент=StandaloneModeCheckCanWriteCommonDataDocument
АвтономнаяРаботаПроверитьВозможностьЗаписиОбщихДанныхКонстанта=StandaloneModeCheckCanWriteCommonDataConstant
АвтономнаяРаботаПроверитьВозможностьЗаписиОбщихДанныхНаборЗаписей=StandaloneModeCheckCanWriteCommonDataRecordSet
АвтономнаяРаботаПроверитьВозможностьЗаписиОбщихДанныхНаборЗаписейРасчета=StandaloneModeCheckCanWriteCommonDataCalculationRecordSet
АвтономнаяРаботаСлужебный=StandaloneModeInternal
АвтономнаяРаботаСлужебныйКлиент=StandaloneModeInternalClient
АвтономноеРабочееМесто=StandaloneWorkstation
Автор=Author
АвторВерсии=VersionAuthor
АвторИзменения=ChangeAuthor
АвторизованныйПользователь=AuthorizedUser
АвторСтрокой=AuthorString
АвторФайлов=FilesAuthor
АгрегироватьСуммуВОтчетах=ShowAggregatedValuesInReports
Администратор=Administrator
АдминистраторСистемы=SystemAdministrator
Администраторы=Administrators
Администрирование=Administration
АдминистрированиеКластера=ClusterAdministration
АдминистрированиеКластераCOM=ClusterAdministrationCOM
АдминистрированиеКластераCOMКлиентСервер=ClusterAdministrationCOMClientServer
АдминистрированиеКластераRAS=ClusterAdministrationRAS
АдминистрированиеКластераRASКлиентСервер=ClusterAdministrationRASClientServer
АдминистрированиеКластераКлиентСервер=ClusterAdministrationClientServer
АдминистрированиеОбменаДанными=DataExchangeAdministration
АдминистрированиеОбменаДанными_2_4_5_1=DataExchangeAdministration_2_4_5_1
АдминистрированиеОбменаДаннымиКонтроль=DataExchangeAdministrationControl
АдминистрированиеОбменаДаннымиУправление=DataExchangeAdministrationManagement
Адрес=Address
АдресатЗапретаИзменения=PeriodClosingTarget
Адресаты=SMSMessageRecipients
АдресаУведомленияОПрочтении=ReadReceiptAddresses
АдресДляВосстановленияПароляУчетнойЗаписи=AccountPasswordRecoveryAddress
АдресКомпоновщикаВсехДокументов=AllDocumentsComposerAddress
АдресМеждународный=InternationalAddress
АдреснаяКнига=AddressBook
АдресОтвета=ReplyToAddress
АдресПубликацииИнформационнойБазыВИнтернете=InfobasePublicationURL
АдресПубликацииИнформационнойБазыВЛокальнойСети=LocalInfobasePublishingURL
АдресРезультата=ResultAddress
АдресХранилищаФормы=FormStorageAddress
АдресЭлектроннойПочты=Email
АдресЭП=EMAddress
АктивныеПользователи=ActiveUsers
АктуальнаяДатаОбновленияПовторноИспользуемыхЗначенийМРО=ORMCachedValuesLatestUpdate
АлгоритмПодписи=SignAlgorithm
АлгоритмХеширования=HashAlgorithm
АлгоритмШифрования=EncryptAlgorithm
АнализВерсийОбъектов=ObjectVersionsAnalysis
АнализЖурналаРегистрации=EventLogAnalysis
АнализЖурналаРегистрацииКлиент=EventLogAnalysisClient
АнализЖурналаРегистрацииСлужебный=EventLogAnalysisInternal
АнализОпроса=PollStatistics
АнализПравДоступа=AccessRightsAnalysis
АналитическийОтчетПоАнкетированию=SurveysAnalyticalReport
Анкета=Questionnaire
Анкетирование=Surveys
АнкетированиеКлиент=SurveysClient
АнкетированиеКлиентСервер=SurveysClientServer
АрхивАнкет=ArchivedQuestionnaires
АрхивАнкета=ArchiveQuestionnaire
Архивировать=Archive
АрхивироватьФайл=ArchiveFile
АутентификацияWindowsИнформационнойБазыДляПодключения=InfobaseToConnectWindowsAuthentication
АутентификацияВСервисе=AuthenticationInService
БазоваяФункциональность=Core
БазоваяФункциональностьВМоделиСервиса=CoreSaaS
БазовыеПраваБСП=BasicSSLRights
БазовыеПраваВнешнихПользователейБСП=BasicSSLRightsForExternalUsers
БазовыйКалендарь=BasicCalendar
Банки=Banks
БезДанных=NoData
БезНастройки=NoSettings
БезопаснаяЗагрузка=SafeImport
БезопасноеХранилищеДанных=SafeDataStorage
БезопасноеХранилищеДанныхОбластейДанных=SafeDataAreaDataStorage
БезопасныйРежим=SafeMode
БезСжатия=NoCompression
Бессрочно=Indefinitely
БиблиотекаСтандартныхПодсистем=StandardSubsystemsLibrary
БизнесПроцесс=BusinessProcess
БизнесПроцессОбъект=BusinessProcessObject
БизнесПроцессы=BusinessProcesses
БизнесПроцессыИЗадачи=BusinessProcessesAndTasks
БизнесПроцессыИЗадачиВызовСервера=BusinessProcessesAndTasksServerCall
БизнесПроцессыИЗадачиКлиент=BusinessProcessesAndTasksClient
БизнесПроцессыИЗадачиКлиентПереопределяемый=BusinessProcessesAndTasksClientOverridable
БизнесПроцессыИЗадачиКлиентСервер=BusinessProcessesAndTasksClientServer
БизнесПроцессыИЗадачиПереопределяемый=BusinessProcessesAndTasksOverridable
БизнесПроцессыИЗадачиСервер=BusinessProcessesAndTasksServer
БизнесПроцессыИЗадачиСобытия=BusinessProcessesAndTasksEvents
БлокироватьИнтерфейс=LockInterface
БлокировкаАдминистраторомСервиса=LockByServiceAdministrator
БлокировкаВладельцем=LockByOwner
БлокировкаРаботыПользователей=ApplicationLock
БлокировкаРаботыСВнешнимиРесурсами=ExternalResourcesOperationsLock
БлокировкаРаботыСВнешнимиРесурсамиПереопределяемый=ExternalResourcesOperationsLockOverridable
БлокировкаСоединенийСИнформационнойБазой=InfobaseConnectionsLock
БлокировкиСеансовОбластейДанных=DataAreaSessionLocks
БлокируемыеОбъекты=ObjectsToLock
Булево=Boolean
БуферОбмена=Clipboard
БуферОперацийСтатистики=StatisticsOperationsClipboard
БыстрыеНастройкиОтчета=QuickReportSettings
БыстрыйДоступ=QuickAccess
БыстрыйДоступДобавить=QuickAccessAdd
БыстрыйДоступКДополнительнымОтчетамИОбработкам=QuickAccessToAdditionalReportsAndDataProcessors
БыстрыйДоступСФлажком=QuickAccessWithFlag
БыстрыйДоступУдалить=QuickAccessRemove
ВажнаяИнформация=ImportantInformation
ВажнаяНадписьШрифт=ImportantLabelFont
Важность=Importance
ВажностьПроблемы=IssueSeverity
ВажностьПроблемыУчета=AccountingIssueSeverity
Важный=Important
Валюта=Currency
Валюты=Currencies
Вариант=Variant
ВариантВыгрузки=ExportOption
ВариантВыполнения=ExecutionOption
ВариантДампа=DumpOption
ВариантДоступа=AccessOption
ВариантЗаписиОбъекта=ObjectWriteOption
ВариантЗапуска=StartupOption
ВариантНастройкиОбмена=ExchangeSetupOption
ВариантРаботыМастера=WizardRunOption
ВариантРасписанияРезервногоКопирования=BackupScheduleOption
ВариантФильтраКомментарий=FilterOptionComment
ВариантыВажностиВзаимодействия=InteractionImportanceOptions
ВариантыВажностиЗадачи=TaskImportanceOptions
ВариантыВерсионированияОбъектов=ObjectsVersioningOptions
ВариантыИспользованияВнешнихКомпонент=AddInUsageOptions
ВариантыОтветовАнкет=QuestionnaireAnswersOptions
ВариантыОтчетов=ReportsOptions
ВариантыОтчетовВызовСервера=ReportsOptionsServerCall
ВариантыОтчетовДоступныеВсемПользователям=ReportsOptionsAvailableForAllUsers
ВариантыОтчетовКлиент=ReportsOptionsClient
ВариантыОтчетовКлиентСервер=ReportsOptionsClientServer
ВариантыОтчетовПередУдалениемИдентификатораОбъектаМетаданных=ReportsOptionsBeforeDeleteMetadataObjectID
ВариантыОтчетовПереопределяемый=ReportsOptionsOverridable
ВариантыОтчетовПовтИсп=ReportsOptionsCached
ВариантыОтчетовПриУдаленииПользователя=ReportsOptionsOnDeleteUser
ВариантыОтчетовСлужебный=ReportsOptionsInternal
ВариантыОтчетовСлужебныйКлиент=ReportsOptionsInternalClient
ВариантыОтчетовСлужебныйКлиентСервер=ReportsOptionsInternalClientServer
ВариантыОчисткиФайлов=FilesCleanupOptions
ВариантыПериода=PeriodOptions
ВариантыПредставленияПериода=PeriodPresentationOptions
ВариантыПубликацииДополнительныхОтчетовИОбработок=AdditionalReportsAndDataProcessorsPublicationOptions
ВариантыСжатияTIFF=TIFFCompressionTypes
ВводАдресаВСвободнойФорме=FreeFormAddressInput
ВводЗначенийСпискомСФлажками=InputValuesInListWithCheckBoxes
ВводимыеСимволыВидны=CharsBeingTypedShown
ВводимыеСимволыСкрыты=CharsBeingTypedHidden
ВводитьНомерПоМаске=EnterNumberByMask
ВводКонтактнойИнформации=ContactInformationInput
ВводНаРазныхЯзыках=InputInMultipleLanguages
ВводПароля=PasswordInput
ВводТелефона=PhoneInput
ВебСайт=Website
ВебСтраница=WebPage
ВерсииИнтерфейса=InterfaceVersions
ВерсииОбъектов=ObjectsVersions
ВерсииПараметровШаблонов=TemplatesParametersVersions
ВерсииПодсистем=SubsystemsVersions
ВерсииПодсистемОбластейДанных=DataAreasSubsystemsVersions
ВерсииРасширений=ExtensionsVersions
ВерсииФайла=FileVersions
ВерсииФайлов=FilesVersions
ВерсииШаблоновОграниченияДоступа=AccessRestrictionTemplatesVersions
ВерсионированиеОбъектов=ObjectsVersioning
ВерсионированиеОбъектовКлиент=ObjectsVersioningClient
ВерсионированиеОбъектовПереопределяемый=ObjectsVersioningOverridable
ВерсионированиеОбъектовСлужебныйВызовСервера=ObjectsVersioningInternalServerCall
ВерсионированиеОбъектовСобытия=ObjectsVersioningEvents
ВерсионироватьПриЗаписи=VersionizeOnWrite
ВерсионироватьПриПроведении=VersionizeOnPost
ВерсионироватьПриСтарте=VersionizeOnStart
ВерсионируемыеДанные=VersionedData
ВерсионируемыеДанныеОбъект=VersionedDataObject
Версия=Version
Версия_2_1_3=Version_2_1_3
Версия_2_2_2=Version_2_2_2
ВерсияGUID=GUIDVersion
ВерсияВладелец=VersionOwner
ВерсияДатЗапретаИзменения=PeriodClosingDatesVersion
ВерсияКлассификатораБанков=BankClassifierVersion
ВерсияКорреспондента=CorrespondentVersion
ВерсияКорреспондента_2_0_1_6=CorrespondentVersion_2_0_1_6
ВерсияКорреспондента_2_1_1_7=CorrespondentVersion_2_1_1_7
ВерсияМакета=TemplateVersion
ВерсияОбъекта=ObjectVersion
ВерсияПлатформы=PlatformVersion
ВерсияПлатформыИнформационнойБазыДляПодключения=InfobaseToConnectPlatformVersion
ВерсияПорядок=VersionOrder
ВерсияПравилОбмена=ExchangeRulesVersion
ВерсияПрисоединенногоФайла=AttachedFileVersion
ВерсияПроигнорирована=VersionIgnored
ВерсияРасширений=ExtensionsVersion
ВерсияРегистрации=RegistrationVersion
ВерсияФайла=FileVersion
ВерсияФормата=FormatVersion
ВерсияФорматаОбмена=ExchangeFormatVersion
ВерсияФорматаФайлаНастроекОбменаДанными=ExchangeDataSettingsFileFormatVersion
ВерсияЧислом=VersionAsNumber
ВертикальноеПоложениеВерх=VerticalLocationTop
ВертикальноеПоложениеНиз=VerticalLocationBottom
ВертикальноеПоложениеЦентр=VerticalLocationCenter
Вес=Weight
ВесЗамера=MeasurementWeight
ВестиДополнительныйКонтрольЗаписиВXML=WriteToXMLAdvancedMonitoring
Взаимодействие=Interaction
ВзаимодействиеОснование=InteractionBasis
Взаимодействия=Interactions
ВзаимодействияВызовСервера=InteractionsServerCall
ВзаимодействияКлиент=InteractionsClient
ВзаимодействияКлиентПереопределяемый=InteractionsClientOverridable
ВзаимодействияКлиентСервер=InteractionsClientServer
ВзаимодействияКлиентСерверПереопределяемый=InteractionsClientServerOverridable
ВзаимодействияКлиентСерверСлужебныйПовтИсп=InteractionsClientServerInternalCached
ВзаимодействияПереопределяемый=InteractionsOverridable
ВзаимодействияПоКонтакту=InteractionsByContact
ВзаимодействияПоПредмету=InteractionsBySubject
ВзаимодействияСобытия=InteractionsEvents
Вид=Kind
ВидДляСписка=KindForList
ВидДня=DayKind
ВидДняПроизводственногоКалендаряВоскресеньеЦвет=BusinessCalendarDayKindSundayColor
ВидДняПроизводственногоКалендаряНеУказанЦвет=BusinessCalendarDayKindColorNotSpecified
ВидДняПроизводственногоКалендаряПраздникЦвет=BusinessCalendarDayKindHolidayColor
ВидДняПроизводственногоКалендаряПредпраздничныйЦвет=BusinessCalendarDayKindDayPreholidayColor
ВидДняПроизводственногоКалендаряРабочийЦвет=BusinessCalendarDayKindWorkdayColor
ВидДняПроизводственногоКалендаряСубботаЦвет=BusinessCalendarDayKindSaturdayColor
ВидДоступа=AccessKind
Виден=isVisible
Видимость=Visible
ВидимостьПоУмолчанию=DefaultVisibility
ВидимостьПоУмолчаниюПереопределена=DefaultVisibilityOverridden
ВидПереключателя=RadioButtonType
ВидПоляДругое=FieldKindOther
ВидПочтовогоАдресаПолучателей=RecipientsEmailAddressKind
ВидПравил=RulesKind
ВидПроверки=CheckKind
ВидРазрешения=PermissionKind
ВидРедактирования=EditingOption
ВидСравнения=ComparisonType
ВидСтатистики=StatisticsKind
ВидТранспортаОбмена=ExchangeTransportKind
ВидТранспортаСообщенийОбмена=ExchangeMessagesTransportKind
ВидТранспортаСообщенийОбменаПоУмолчанию=DefaultExchangeMessagesTransportKind
ВидФлажка=CheckBoxType
ВидыДнейПроизводственногоКалендаря=BusinessCalendarDaysKinds
ВидыДополнительныхОтчетовИОбработок=AdditionalReportsAndDataProcessorsKinds
ВидыДоступа=AccessKinds
ВидыДоступаБезГруппДляЗначенияДоступа=AccessKindsWithoutGroupsForAccessValues
ВидыДоступаСОднойГруппойДляЗначенияДоступа=AccessKindsWithSingleGroupForAccessValue
ВидыДоступаСОтключеннымИспользованием=DisabledAccessKinds
ВидыКонтактнойИнформации=ContactInformationKinds
ВидыНавигацииПоВзаимодействиямОтДопРеквизитовСведений=InteractionNavigationTypesByAdditionalInfoAndAttributes
ВидыНавигацииПоВзаимодействиямОтКатегорий=InteractionNavigationTypesByCategories
ВидыНавигацииПоВзаимодействиямОтКонтактов=InteractionNavigationTypesByContacts
ВидыНавигацииПоВзаимодействиямОтПредметовВзаимодействий=InteractionNavigationTypesByInteractionSubjects
ВидыНавигацииПоВзаимодействиямОтРеквизитаПредмета=InteractionNavigationTypesBySubjectAttribute
ВидыНазначенияДатЗапрета=PeriodClosingDatesPurposeTypes
ВидыОпераций=OperationKinds
ВидыПереключателяВАнкетах=RadioButtonTypesInQuestionnaires
ВидыПравилДляОбменаДанными=DataExchangeRulesTypes
ВидыПроверок=ChecksKinds
ВидыСравнения=ComparisonKinds
ВидыТранспортаСообщенийОбмена=ExchangeMessagesTransportTypes
ВидыФлажкаВАнкетах=CheckBoxKindsInQuestionnaires
ВИнформационнойБазе=InInfobase
ВключатьДатуВИмяФайла=IncludeDateInFileName
ВключатьПодписьДляНовыхСообщений=AddSignatureForNewMessages
ВключатьПодписьПриОтветеПересылке=AddSignatureOnReplyForward
ВключатьСтрануВПредставление=IncludeCountryInPresentation
ВключатьТелоИсходногоПисьма=IncludeOriginalEmailBody
ВключаяНижестоящие=IncludeSubordinateAccessValues
Включен=Enabled
ВключитьИспользованиеПланаОбмена=EnableExchangePlanUsage
ВключитьРегламентноеЗаданиеПриИзмененииФункциональнойОпции=EnableScheduledJobOnChangeFunctionalOption
ВКонтакте16=VKontakte16
Владелец=Owner
ВладелецВнешнихЗначенийВНаборахЗначенийДоступаОбъект=ExternalValuesOwnerInAccessValueSetsObject
ВладелецГрафика=ScheduleOwner
ВладелецГрафикаРаботы=WorkScheduleOwner
ВладелецДополнительныхЗначений=AdditionalValuesOwner
ВладелецДополнительныхСведений=DetailedInfoOwner
ВладелецЗначенийКлючейДоступа=AccessKeysValuesOwner
ВладелецЗначенийКлючейДоступаДокумент=AccessKeysValuesOwnerDocument
ВладелецЗначенийКлючейДоступаНаборЗаписей=AccessKeysValuesOwnerRecordSet
ВладелецЗначенийКлючейДоступаНаборЗаписейРегистраРасчета=AccessKeysValuesOwnerCalculationRegisterRecordSet
ВладелецЗначенийКлючейДоступаОбъект=AccessKeysValuesOwnerObject
ВладелецКонтактнойИнформации=ContactInformationOwner
ВладелецНаборовЗначенийДоступаОбъект=AccessValuesSetsOwnerObject
ВладелецНастроекПрав=RightsSettingsOwner
ВладелецНастроекПравОбъект=RightsSettingsOwnerObject
ВладелецПрисоединенныхФайлов=AttachedFilesOwner
ВладелецПрисоединенныхФайловОбъект=AttachedFilesOwnerObject
ВладелецСОграничениемПоНаборамЗначенийДоступаДокумент=OwnerWithRestrictedAccessValueSetsDocument
ВладелецСОграничениемПоНаборамЗначенийДоступаОбъект=OwnerLimitedByAccessValuesSetsObject
ВладелецУчетнойЗаписи=AccountOwner
ВладелецФайла=FileOwner
ВладелецФайлов=FilesOwner
ВладелецФайловШрифт=FilesOwnerFont
ВладелецШаблона=TemplateOwner
ВладелецШаблонаСообщения=MessageTemplateOwner
ВлевоНа90=Left90
ВнешнееЗадание=ExternalJob
ВнешниеКомпоненты=AddIns
ВнешниеКомпонентыВМоделиСервиса=AddInsSaaS
ВнешниеКомпонентыВМоделиСервисаСлужебный=AddInsSaaSInternal
ВнешниеКомпонентыВМоделиСервисаСлужебныйКлиент=AddInsSaaSInternalClient
ВнешниеКомпонентыВызовСервера=AddInServerCall
ВнешниеКомпонентыКлиент=AddInsClient
ВнешниеКомпонентыСервер=AddInsServer
ВнешниеКомпонентыСлужебный=AddInsInternal
ВнешниеКомпонентыСлужебныйВызовСервера=AddInsInternalServerCall
ВнешниеКомпонентыСлужебныйКлиент=AddInsInternalClient
ВнешниеПользователи=ExternalUsers
ВнешниеПользователиКлиент=ExternalUsersClient
Внешний=External
ВнешнийДоступ=ExternalAccess
ВнешнийПользователь=ExternalUser
ВнешнийПользовательОбъект=ExternalUserObject
ВнешняяКомпонентаДоступна=AddInIsAvailable
ВнешняяКомпонентаНеДоступна=AddInNotAvailable
ВнешняяОбработка=ExternalDataProcessor
ВнешняяРоль=ExternalRole
ВнешняяСистема=ExternalSystem
ВнешняяСсылкаНаОбъектИнформационнойБазы=ExternalLinkToInfobaseObject
Внутренний=BuiltIn
ВнутреннийЗаголовок=InternalTitle
ВоВстроенномРедакторе=UsingBuiltInEditor
ВозможностьПредварительногоСохранения=AllowSavingQuestionnaireDraft
Вопрос=DoQueryBox
Вопрос32=DoQueryBox32
ВопросОбУстановкеВнешнейКомпоненты=AddInInstallationQuestion
ВопросОбУстановкеРасширенияРаботыСКриптографией=QuestionInstallCryptographyExtension
ВопросОбУстановкеРасширенияРаботыСФайлами=FileSystemExtensionInstallationQuestion
ВопросПриИмпортеФайлов=QuestionOnFileImport
ВопросСУсловием=QuestionWithCondition
ВопросыДляАнкетирования=QuestionsForSurvey
ВопросыШаблонаАнкеты=QuestionnaireTemplateQuestions
ВосклицательныйЗнакКрасный=ExclamationPointRed
ВосклицательныйЗнакСерый=ExclamationMarkGray
Воскресенье=Sunday
ВосстанавливатьИнформационнуюБазу=RestoreInfobase
ВосстановлениеДанныхИзРезервнойКопии=RestoreDataFromBackup
ВосстановлениеПаролей=PasswordsRecovery
ВосстановлениеСвязиСГлавнымУзлом=ReconnectToMasterNode
ВправоНа180=Right180
ВправоНа90=Right90
ВПредставлениеВключатьИмяПользователя=IncludeUsernameInPresentation
ВРабочемКаталогеВладельца=InOwnerWorkingDirectory
ВременныйКаталогРаботыСФайлами=TempFilesDirectory
ВремяБлокировки=LockTime
ВремяВыполнения=RunTime
ВремяНачала=BeginTime
ВремяОжидания=Timeout
ВремяОкончания=EndTime
ВремяПоследнейОчисткиФайлов=LastFilesCleanupTime
ВремяПоследнейПопытки=LastAttemptTime
ВремяСобытия=EventTime
ВремяТекущегоСеанса=CurrentSessionTime
Вручную=Manually
ВсеВидыДоступаКромеСпециальных=AllAccessKindsExceptSpecialOnes
ВсеВнешниеПользователи=AllExternalUsers
ВсегдаОтправлятьУведомление=AlwaysSendReadReceipt
ВсеЗадачи=AllTasks
ВсеЗаметки=AllNotes
ВсеОбъектыАвторизации=AllAuthorizationObjects
ВсеОбъектыАдресации=AllAddressingObjects
ВсеПользователи=AllUsers
ВсеРазрешены=AllAllowed
ВсеРазрешеныБезИсключений=AllAllowedWithoutExceptions
ВсеФайлы=AllFiles
ВспомогательнаяФормаНастроекОтчета=ReportSettingsAuxiliaryForm
ВставитьГруппировкуВыше=InsertGroupAbove
ВставитьГруппировкуНиже=InsertGroupBelow
ВставитьИзБуфераОбмена=PasteFromClipboard
ВставитьКолонкуСлева=InsertColumnLeft
ВставитьКолонкуСправа=InsertColumnRight
Встреча=Meeting
ВстречаПрисоединенныеФайлы=MeetingAttachedFiles
Вступление=Introduction
ВТомахНаДиске=InVolumesOnHardDrive
ВУказанноеВремя=AtSpecifiedTime
ВходВПрограммуЗапрещен=AuthorizationDenied
Входящие=IncomingMessages
Входящий=Incoming
ВыбораРежимаОткрытияМакета=SelectTemplateOpeningMode
ВыборВариантаОтчета=ReportOptionSelection
ВыборВидаОбъектаСоставаУзла=SelectNodeCompositionObjectKind
ВыборВидаОбъектов=SelectObjectsKind
ВыборГруппы=SelectGroup
ВыборДаты=SelectDate
ВыборДействияПриОбнаруженииОтличийФайла=SelectActionOnFilesDifference
ВыборИсполнителяБизнесПроцесса=SelectBusinessProcessPerformer
ВыборКодировки=SelectEncoding
ВыборКолонок=SelectColumns
ВыборКонстанты=SelectConstant
ВыборКонтакта=SelectContactPerson
ВыборНастроек=SettingsChoice
ВыборОбластиПоиска=SearchAreaChoice
ВыборОбъектовИнформационнойБазыКорреспондента=SelectCorrespondentInfobaseObjects
ВыборОбъектовМетаданных=SelectMetadataObjects
ВыборОбъектовМетаданныхПоПодсистемам=SelectMetadataObjectsBySubsystems
ВыборОбъектовОтбором=SelectObjectsUsingFilter
ВыборПользователей=SelectUsers
ВыборПользователяОперационнойСистемы=SelectOperatingSystemUser
ВыборПоляОтчета=SelectReportField
ВыборПоОтветственному=SelectGroupsByEmployeeResponsible
ВыборПорядкаВыполнения=SelectExecutionOrder
ВыборПутиКАрхивуФайловТомов=SelectPathToVolumeFilesArchive
ВыборРеквизита=SelectAttribute
ВыборРеквизитовОбъекта=SelectObjectAttributes
ВыборРолиИсполнителя=SelectPerformerRole
ВыборСертификатаДляПодписанияИлиРасшифровки=SelectSigningOrDecryptionCertificate
ВыборСохраненияШифрованногоФайла=SelectEncryptedFileSaveMode
ВыборСпособаСравненияВерсий=SelectVersionCompareMethod
ВыборТипаПредмета=SelectSubjectType
ВыборТиповПользователей=SelectUsersTypes
ВыборУзлаПланаОбмена=SelectExchangePlanNode
ВыборУзловПлановОбмена=SelectExchangePlanNodes
ВыборУстройстваСканирования=ScanningDeviceChoice
ВыборФинансовогоПериода=SelectFiscalPeriod
ВыборФинансовогоПериодаДень=SelectFiscalPeriodDay
ВыборФорматаВложений=SelectAttachmentFormat
ВыборХранимыхВерсий=SelectStoredVersions
ВыбранныеЭлементы=SelectedItems
ВыбратьВариантОтчета=SelectReportOption
ВыводВОкноСообщенийИнформационныхСообщений=OutputInfoMessagesToMessageWindow
ВыводВПротоколИнформационныхСообщений=OutputInfoMessagesToProtocol
ВыводВПротоколСообщенийОбОшибках=OutputErrorMessagesToProtocol
ВыводитьВВидеГиперссылки=OutputAsHyperlink
ВыводНаПринтерФайлБуферОбмена=OutputToPrinterFileClipboard
ВыгружатьВручную=ManualExport
ВыгружатьВсегда=ExportAlways
ВыгружатьПоУсловию=ExportByCondition
ВыгружатьПриНеобходимости=ExportIfNecessary
ВыгружатьТолькоРазрешенные=ExportAllowedObjectsOnly
ВыгрузитьЧастьФайла=ExportFilePart
ВыгрузкаДанных=DataExport
ВыгрузкаДанныхДляСопоставления=ExportMappingData
ВыгрузкаЗагрузкаEnterpriseData=ExportImportEnterpriseData
ВыгрузкаЗагрузкаДанныхСверткаСсылокНаПользователейВРазделенныхДанных=ExportImportDataCollapsingUserReferencesInSeparatedData
ВызовКлиентскогоМетода=ClientMethodCall
ВызовОнлайнПоддержки=ContactOnlineSupport
ВызовОнлайнПоддержкиВызовСервера=CallOnlineSupportServerCall
ВызовОнлайнПоддержкиКлиент=ContactOnlineSupportClient
ВызовОнлайнПоддержкиПереопределяемый=ContactOnlineSupportOverridable
ВызовСерверногоМетода=ServerMethodCall
ВыпадающийСписок=DropDownList
Выполнена=Executed
ВыполненаРегистрацияОтложенныхОбработчиков=DeferredHandlersRegistrationCompleted
ВыполненаСОшибкой=IsFailed
ВыполнениеОбменаДанными=DataExchangeExecution
ВыполнениеСинхронизацииДанных=DataSynchronizationInProgress
ВыполненнаяЗадача=ExecutedTask
Выполнено=Completed2
ВыполненоСПредупреждениями=CompletedWithWarnings
ВыполненСОшибкой=CompletedWithError
ВыполнитьВосстановлениеДанных=ExecuteDataRestoration
ВыполнитьВыгрузку=ExecuteExport
ВыполнитьВыгрузкуДанных=RunDataExport
ВыполнитьДействиеСценарияОбменаДаннымиВоВторойИнформационнойБазе=ExecuteDataExchangeScenarioActionInSecondInfobase
ВыполнитьДействиеСценарияОбменаДаннымиВПервойИнформационнойБазе=ExecuteDataExchangeScenarioActionInFirstInfobase
ВыполнитьДействияПередЗаписьюПрисоединенногоФайла=ExecuteActionsBeforeWriteAttachedFile
ВыполнитьДействияПередУдалениемПрисоединенногоФайла=ExecuteActionsBeforeDeleteAttachedFile
ВыполнитьДействияПослеПолученияДанныхУзлаВРаспределеннойИнформационнойБазе=ExecuteActionsAfterGetNodeDataInDistributedInfobase
ВыполнитьДействияПриЗаписиПрисоединенногоФайла=ExecuteActionsOnWriteAttachedFile
ВыполнитьЗагрузку=ExecuteImport
ВыполнитьЗагрузкуДанных=RunDataImport
ВыполнитьКорректировкуИнформацииСопоставления=AdjustMappingData
ВыполнитьОбменДаннымиВОптимизированномФормате=ExecuteDataExchangeInOptimizedFormat
ВыполнитьОтправкуДанных=ExecuteDataSending
ВыполнитьРегламентноеЗаданиеВручную=ExecuteScheduledJobManually
ВыполнитьРезервноеКопированиеСейчас=CreateBackupNow
ВыполнитьСейчас=ExecuteNow
ВыполняемоеДействие=CurrentAction
ВыполняетсяЗаписьОбъекта=ObjectWritingInProgress
ВыполняетсяОбновлениеИБ=IBUpdateInProgress
ВыполняетсяУдалениеОбъектов=ObjectsDeletionInProgress
ВыполнятьАвтоматическоеРезервноеКопирование=CreateBackupAutomatically
ВыполнятьВГруппеОбязательных=ExecuteInMandatoryGroup
ВыполнятьЗамерыПроизводительности=RunPerformanceMeasurements
ВыполнятьПоРасписанию=ExecuteOnSchedule
ВыравниваниеПоЛевомуКраю=AlignLeft
ВыравниваниеПоПравомуКраю=AlignRight
ВыравниваниеПоЦентру=AlignCenter
ВыравниваниеПоШирине=Justify
ВыслатьОтчетНаПочту=EmailReport
Высокая=High
ВысотаСтроки=RowHeight
Выявлено=Detected
ГенерацияШтрихкода=BarcodeGeneration
ГенерацияШтрихкодаСерверПовтИсп=BarcodeGenerationServerCached
ГеографическиеСхемы=GeographicalSchemas
Гиперссылка=Hyperlink
ГиперссылкаЦвет=HyperlinkColor
ГлавнаяЗадача=MainTask
ГлавныйУзел=MasterNode
Год=Year
Голубой=LightBlue
ГоризонтПланирования=PlanningHorizon
Город=City
ГородМеждународный=CityInternationalFormat
ГотовКСтарту=ReadyToStart
ГрадацииСерого=Grayscale
ГраницаВезде=AllBorders
ГраницаВнутри=InsideBorder
ГраницаВокруг=OutsideBorder
ГраницаСверху=TopBorder
ГраницаСлева=LeftBorder
ГраницаСнизу=BottomBorder
ГраницаСправа=RightBorder
ГрафикиРаботы=WorkSchedules
ГрафикиРаботыКлиент=WorkSchedulesClient
ГрафикРаботы=WorkScheduleCalendar
ГрафическиеСхемы=GraphicalSchemas
ГруппаВариантовОтчетовВажнаяШрифт=ImportantReportsOptionsGroupFont
ГруппаВариантовОтчетовОбычнаяШрифт=RegularReportsOptionsGroupFont
ГруппаВариантовОтчетовЦвет=ReportsOptionsGroupColor
ГруппаВариантовОтчетовЦвет82=ReportsOptionsGroupColor82
ГруппаВыбранныхПолей=SelectedFieldsGroup
ГруппаДанных=DataGroup
ГруппаДоступа=AccessGroup
ГруппаЗначенийДоступа=AccessValuesGroup
ГруппаИсполнителейЗадач=TaskPerformersGroup
ГруппаИсполнителейЗадачПроверяющий=TaskPerformersGroupSupervisor
ГруппаОбновления=UpdateGroup
ГруппаПользователей=UsersGroup
ГруппаФайлов=FilesGroup
ГруппироватьПоОтчету=GroupByReport
ГрупповоеИзменениеОбъектов=BatchEditObjects
ГрупповоеИзменениеОбъектовКлиент=BatchEditObjectsClient
ГрупповоеИзменениеОбъектовПереопределяемый=BatchEditObjectsOverridable
ГрупповоеИзменениеРеквизитов=BatchEditAttributes
Группы=Groups
ГруппыВнешнегоПользователя=ExternalUserGroups
ГруппыВнешнихПользователей=ExternalUsersGroups
ГруппыДоступа=AccessGroups
ГруппыЗначенийДоступа=AccessValuesGroups
ГруппыИсполнителейЗадач=TaskPerformersGroups
ГруппыПользователей=UserGroups
ГруппыПользователя=OpenUserGroups
ДампыПлатформы=PlatformDumps
Данные=Data
ДанныеБизнесПроцессов=BusinessProcessesData
ДанныеДляОтложенногоОбновления=DataForDeferredUpdate
ДанныеОбработанныеВЦентральномУзлеРИБ=DataProcessedInMasterDIBNode
ДанныеОбъектовДляРегистрацииВОбменах=ObjectsDataToRegisterInExchanges
ДанныеПроизводственногоКалендаря=BusinessCalendarData
ДанныеСертификата=CertificateData
ДанныеУспешноЗагружены=DataImportedSuccessfully
Дата=Date
ДатаАвтоматическогоЗапрещенияВхода=AutomaticAuthorizationProhibitionDate
ДатаАктуальностиОтправки=EmailSendingRelevanceDate
ДатаБлокировки=LockDate
ДатаВерсии=VersionDate
ДатаВозникновения=OccurrenceDate
ДатаВремяОбновления=UpdateDateTime
ДатаВыгрузкиДанных=DataExportDate
ДатаГрафика=ScheduleDate
ДатаГрафикаИзмененнаяФон=ChangedScheduleDateBackground
ДатаДокумента=DocumentDate
ДатаЗавершения=CompletedOn
ДатаЗагрузкиПисем=EmailsImportDate
ДатаЗаема=LockedDate
ДатаЗакладкиСообщения=MessageStoredDate
ДатаЗаписи=RecordDate
ДатаЗаписиЛокальная=RecordDateLocal
ДатаЗаписиНачалоЧаса=RecordDateBegOfHour
ДатаЗапрета=PeriodEndClosingDate
ДатаИзменения=ChangeDate
ДатаИзмененияЗаписиРегистра=RegisterRecordChangeDate
ДатаИсполнения=CompletionDate
ДатаКогдаОтправить=DateToSendEmail
ДатаМодификацииУниверсальная=UniversalModificationDate
ДатаМодификацииФайла=FileModificationDate
ДатаНачала=StartDate
ДатаНачалаЗамера=MeasurementStartDate
ДатаНачалаИспользованияПароля=PasswordUsageStartDate
ДатаНачалаПроверки=CheckStartDate
ДатаОбновления=UpdateDate
ДатаОбновленияПовторноИспользуемыхЗначенийМРО=ORMCachedValuesRefreshDate
ДатаОкончания=EndDate
ДатаОтложенногоСтарта=DeferredStartDate
ДатаОтправления=PostingDate
ДатаОтсчета=StartingDate
ДатаПереноса=ReplacementDate
ДатаПодписи=SignatureDate
ДатаПолучения=DateReceived
ДатаПомещенияВРабочийКаталог=PutFileInWorkingDirectoryDate
ДатаПоследнегоВзаимодействия=LastInteractionDate
ДатаПоследнегоИзменения=LastChangeDate
ДатаПоследнегоИспользования=DateOfLastUse
ДатаПоследнегоОбновленияКлассификатораОшибок=LatestErrorsClassifierUpdateDate
ДатаПоследнегоОбновленногоЭлемента=LatestUpdatedItemDate
ДатаПоследнейАктивности=LastActivityDate
ДатаПоследнейВыгрузкиЗамеровПроизводительностиUTC=LastPerformanceMeasurementsExportDateUTC
ДатаПринятияКИсполнению=AcceptForExecutionDate
ДатаПроверкиПодписи=SignatureValidationDate
ДатаПрочтения=ReadDate
ДатаРазрешенияВходаВПрограмму=AuthorizationAllowedDate
ДатаРегистрации=RegistrationDate
ДатаРедактирования=EditDate
ДатаСинхронизацииЗавершение=SynchronizationDateCompletion
ДатаСинхронизацииНачало=SynchronizationDateStart
ДатаСоздания=CreationDate
ДатаУведомленияОНовыхЗадачах=NewTasksNotificationDate
ДатыЗапретаЗагрузки=ImportRestrictionDates
ДатыЗапретаЗагрузкиДанных=DataImportRestrictionDates
ДатыЗапретаИзменения=PeriodClosingDates
ДатыЗапретаИзмененияДанных=PeriodEndClosingDates
ДатыЗапретаИзмененияПереопределяемый=PeriodClosingDatesOverridable
ДатыЗапретаИзмененияСлужебный=PeriodClosingDatesInternal
ДатыЗапретаИзмененияСлужебныйКлиент=PeriodClosingDatesInternalClient
ДатыЗапретаИзмененияСлужебныйКлиентСервер=PeriodClosingDatesInternalClientServer
ДатыЗапретаИзмененияСлужебныйПовтИсп=PeriodClosingDatesInternalCached
ДатыПоследнейЗагрузкиПочтовыхСообщений=LastEmailImportDate
ДвиженияДокумента=DocumentRegisterRecords
ДвоичныеДанныеФайла=FileBinaryData
ДвоичныеДанныеФайлов=BinaryFilesData
Действие=Action
ДействиеВКолонкеСпискаШрифт=ActionInListColumnFont
ДействиеВыполнить=ActionExecute
ДействиеПриОбмене=ActionOnExchange
ДействиеПроверить=ActionCheck
ДействителенДо=ValidBefore
ДействияПриОбмене=ActionsOnExchange
ДействияСФайламиПоДвойномуЩелчку=DoubleClickFileActions
ДействующиеДатыЗапретаИзменения=ValidPeriodClosingDates
Декада=TenDays
ДенежнаяСуммаЛюбогоЗнака=MonetaryAmountPositiveNegative
ДенежнаяСуммаНеотрицательная=MonetaryAmountNonNegative
День=Day
ДеньВключенВГрафик=DayAddedToSchedule
ДетализироватьОбновлениеИБВЖурналеРегистрации=WriteIBUpdateDetailsToEventLog
ДеятельностьПрекращена=OutOfBusiness
Диаграмма=Chart
Длина=Length
Длительная=TimeConsuming
ДлительнаяОперация=TimeConsumingOperation
ДлительнаяОперация16=TimeConsumingOperation16
ДлительнаяОперация48=TimeConsumingOperation48
ДлительностьОбработки=ProcessingDuration
ДлительныеОперации=TimeConsumingOperations
ДлительныеОперацииВызовСервера=TimeConsumingOperationsServerCall
ДлительныеОперацииГлобальный=TimeConsumingOperationsGlobal
ДлительныеОперацииКлиент=TimeConsumingOperationsClient
ДляВнешнихПользователей=ForExternalUsers
ДляВсехИнформационныхБаз=ForAllInfobases
ДляВсехПользователей=ForAllUsers
ДляЗаписиОбъектовИПроверкиПрав=ForWritingObjectsAndCheckingRights
ДляОтчетаПоПравамДоступа=ForAccessRightsReport
ДляРабочегоСтола=ForDesktop
ДляШаблоновВСеансахВнешнихПользователей=ForTemplatesInExternalUsersSessions
ДляШаблоновВСеансахПользователей=ForTemplatesInUsersSessions
Добавил=Added
ДобавитьКомплексныйВопрос=AddComplexQuestion
ДобавитьПользователейСервиса=AddServiceUsers
ДобавитьПростойВопрос=AddSimpleQuestion
ДобавитьРазделАнкеты=AddQuestionnaireSection
ДобавитьРодительский=AddParentOption
ДобавитьТабличныйВопрос=AddTabularQuestion
ДобавитьУсловныйВопрос=AddConditionalQuestion
ДобавитьЭлементНастроек=AddSettingsItem
ДобавлениеИзменениеБанков=AddEditBanks
ДобавлениеИзменениеВариантовОтчетов=AddEditReportsOptions
ДобавлениеИзменениеВзаимодействий=AddEditInteractions
ДобавлениеИзменениеВидовКонтактнойИнформации=AddEditContactInfoKind
ДобавлениеИзменениеВнешнихПользователей=AddEditExternalUsers
ДобавлениеИзменениеГрафиковРаботы=AddEditWorkSchedules
ДобавлениеИзменениеДатЗапретаИзменения=AddEditPeriodClosingDates
ДобавлениеИзменениеДополнительныхОтчетовИОбработок=AddEditAdditionalReportsAndDataProcessors
ДобавлениеИзменениеДополнительныхРеквизитовИСведений=AddEditAdditionalAttributesAndInfo
ДобавлениеИзменениеЗаданий=AddEditJobs
ДобавлениеИзменениеЗаметок=AddEditNotes
ДобавлениеИзменениеКалендарныхГрафиков=AddEditCalendarSchedules
ДобавлениеИзменениеКурсовВалют=AddEditCurrencyRates
ДобавлениеИзменениеЛичныхВариантовОтчетов=AddEditPersonalReportsOptions
ДобавлениеИзменениеЛичныхШаблоновСообщений=AddEditPersonalMessageTemplates
ДобавлениеИзменениеНапоминаний=AddEditNotifications
ДобавлениеИзменениеОпросов=AddEditPolls
ДобавлениеИзменениеОтветовНаВопросыАнкет=AddEditQuestionnaireQuestionsAnswers
ДобавлениеИзменениеПапокИФайлов=AddEditFoldersAndFiles
ДобавлениеИзменениеПапокИФайловВнешнимиПользователями=AddEditFoldersAndFilesByExternalUsers
ДобавлениеИзменениеПользователей=AddEditUsers
ДобавлениеИзменениеРассылокОтчетов=AddEditReportBulkEmails
ДобавлениеИзменениеРолейИсполнителей=AddEditPerformersRoles
ДобавлениеИзменениеСостоянийОригиналовПервичныхДокументов=AddEditSourceDocumentsOriginalsStates
ДобавлениеИзменениеУчетныхЗаписейЭлектроннойПочты=AddEditEmailAccounts
ДобавлениеИзменениеШаблоновАнкет=AddEditQuestionnairesTemplates
ДобавлениеИзменениеШаблоновСообщений=AddEditMessageTemplates
ДобавлениеИзменениеЭлектронныхПодписейИШифрование=AddEditDigitalSignaturesAndEncryption
ДобавлениеСертификата=AddingCertificate
ДобавлениеСертификатаДляШифрования=AddEncryptionCertificate
ДобавлениеЭлектроннойПодписиИзФайла=AddDigitalSignatureFromFile
ДобавленияУсловияПоДате=AddConditionByDate
ДобавленныйРеквизитФон=AddedAttributeBackground
ДобавляемыеРазрешения=PermissionsToAdd
ДокументЗаписанКоннекторВерх=DocumentWrittenConnectorTop
ДокументЗаписанКоннекторВерхНиз=DocumentWrittenConnectorTopBottom
ДокументЗаписанКоннекторЛево=DocumentWrittenConnectorLeft
ДокументЗаписанКоннекторЛевоВерх=DocumentWrittenConnectorLeftTop
ДокументЗаписанКоннекторЛевоНиз=DocumentWrittenConnectorLeftBottom
ДокументЗаписанКоннекторНиз=DocumentWrittenConnectorDown
ДокументПомеченНаУдалениеКоннекторВерх=DocumentMarkedForDeletionConnectorTop
ДокументПомеченНаУдалениеКоннекторВерхНиз=DocumentMarkedForDeletionConnectorTopBottom
ДокументПомеченНаУдалениеКоннекторЛево=DocumentMarkedForDeletionConnectorLeft
ДокументПомеченНаУдалениеКоннекторЛевоВерх=DocumentMarkedForDeletionConnectorLeftTop
ДокументПомеченНаУдалениеКоннекторЛевоНиз=DocumentMarkedForDeletionConnectorLeftBottom
ДокументПомеченНаУдалениеКоннекторНиз=DocumentMarkedForDeletionConnectorBottom
ДокументПроведенКоннекторВерх=DocumentPostedConnectorTop
ДокументПроведенКоннекторВерхНиз=DocumentPostedConnectorTopBottom
ДокументПроведенКоннекторЛево=DocumentPostedConnectorLeft
ДокументПроведенКоннекторЛевоВерх=DocumentPostedConnectorLeftTop
ДокументПроведенКоннекторЛевоНиз=DocumentPostedConnectorLeftBottom
ДокументПроведенКоннекторНиз=DocumentPostedConnectorBottom
Должность=JobTitle
ДоменноеИмяСервера=ServerDomainName
ДописыватьДанныеВПротоколОбмена=AppendDataToExchangeLog
ДополнениеРазрешения=PermissionAddition
ДополнительнаяИнформация=AdditionalInformation
ДополнительнаяОбработка=AdditionalDataProcessor
ДополнительнаяРегистрация=AdditionalRegistration
ДополнительнаяРегистрацияСценарияУзла=AdditionalNodeScenarioRegistration
Дополнительно=More
ДополнительноеОписание=AdditionalDetails
ДополнительныеЗначенияДоступа=AdditionalAccessValues
ДополнительныеЗначенияИспользуются=AdditionalValuesUsed
ДополнительныеЗначенияСВесом=AdditionalValuesWithWeight
ДополнительныеНастройки=AdditionalSettings
ДополнительныеОбработкиАдминистрирование=AdditionalDataProcessorsAdministration
ДополнительныеОтчетыАдминистрирование=AdditionalReportsAdministration
ДополнительныеОтчетыИОбработки=AdditionalReportsAndDataProcessors
ДополнительныеОтчетыИОбработкиВАвтономномРежиме=AdditionalReportsAndDataProcessorsStandaloneMode
ДополнительныеОтчетыИОбработкиВБезопасномРежимеСлужебный=AdditionalReportsAndDataProcessorsSafeModeInternal
ДополнительныеОтчетыИОбработкиВМоделиСервиса=AdditionalReportsAndDataProcessorsSaaS
ДополнительныеОтчетыИОбработкиВМоделиСервисаМанифест=AdditionalReportsAndDataProcessorsSaaSManifest
ДополнительныеОтчетыИОбработкиВМоделиСервисаМанифестИнтерфейс=AdditionalReportsAndDataProcessorsSaaSManifestInterface
ДополнительныеОтчетыИОбработкиВМоделиСервисаПовтИсп=AdditionalReportsAndDataProcessorsSaaSCached
ДополнительныеОтчетыИОбработкиВызовСервера=AdditionalReportsAndDataProcessorsServerCall
ДополнительныеОтчетыИОбработкиКлиент=AdditionalReportsAndDataProcessorsClient
ДополнительныеОтчетыИОбработкиКлиентПереопределяемый=AdditionalReportsAndDataProcessorsClientOverridable
ДополнительныеОтчетыИОбработкиКлиентСервер=AdditionalReportsAndDataProcessorsClientServer
ДополнительныеОтчетыИОбработкиОбъектНазначения=AdditionalReportsAndDataProcessorsRelatedObject
ДополнительныеОтчетыИОбработкиПередУдалениемИдентификатораОбъектаМетаданных=AdditionalReportsAndDataProcessorsBeforeDeleteMetadataObjectID
ДополнительныеОтчетыИОбработкиПереопределяемый=AdditionalReportsAndDataProcessorsOverridable
ДополнительныеОтчетыИОбработкиПовтИсп=AdditionalReportsAndDataProcessorsCached
ДополнительныеОтчетыИОбработкиРегламентныеЗаданияВМоделиСервиса=AdditionalReportsAndDataProcessorsScheduledJobsSaaS
ДополнительныеОтчетыИОбработкиТипФормы=AdditionalReportsAndDataProcessorsFormType
ДополнительныеПараметры=AdditionalParameters
ДополнительныеПараметрыПроксиСервера=AdditionalProxyServerParameters
ДополнительныеРеквизиты=AdditionalAttributes
ДополнительныеРеквизитыИСведения=AdditionalAttributesAndInfo
ДополнительныеРеквизитыОбработкаПроверкиЗаполнения=AdditionalAttributesFillCheckProcessing
ДополнительныеРеквизитыСведения=AdditionalAttributesInfo
ДополнительныеСведения=AdditionalInfo
ДополнительныеСведенияКоманднаяПанель=AdditionalInfoCommandBar
Дополнительный=Additional
ДополнительныйОбъектАдресации=AdditionalAddressingObject
ДополнительныйОбъектАдресацииПроверяющий=AdditionalAddressingObjectSupervisor
ДополнительныйОтчет=AdditionalReport
ДополнительныйОтчетИлиОбработка=AdditionalReportOrDataProcessor
ДополнительныйЯзык1=AdditionalLanguage1
ДополнительныйЯзык2=AdditionalLanguage2
ДопФайлОбновленияКонфигурации=AdditionalConfigurationUpdateFile
ДопФайлРезервногоКопирования=AddlBackupFile
Доставлено=Delivered
Доставляется=DeliveryInProgress
ДоступЗапрещен=AccessDenied
ДоступнаРаботаРИБ=DIBModeAvailable
ДоступнаРегистрацияАсинхронно=AsynchronousRegistrationAvailable
ДоступнаРегистрацияСредствамиБСП=RegisterWithSSLMethodsAvailable
ДоступныеАнкеты=AvailableQuestionnaires
ДоступныеПериодыОтчета=AvailableReportPeriods
ДоступРазрешен=AccessAllowed
Другое=Other
ЕдиницаИзмеренияПериода=PeriodUOM
Ежедневно=Daily
Ежемесячно=Monthly
Еженедельно=Weekly
ЕстьВложения=HasAttachments
ЕстьДанныеВерсии=HasVersionData
ЕстьФайлы=HasFiles
Желтый=Yellow
ЖурналРегистрации=EventLog
ЖурналРегистрацииВызовСервера=EventLogServerCall
ЖурналРегистрацииКлиент=EventLogClient
ЖурналУчетаОригиналовПервичныхДокументов=SourceDocumentsOriginalsRecordingJournal
ЗаблокированныеДляПолученияУчетныеЗаписи=AccountsLockedForReceipt
ЗаблокированныйРеквизитЦвет=LockedAttributeColor
ЗавершенаСОшибкой=OperationFailed
ЗавершенаУспешно=OperationSuccessful
ЗавершениеЗапросаРазрешений=PermissionsRequestEnd
ЗавершениеРаботыПользователей=UsersSessions
ЗавершенныйБизнесПроцесс=CompletedBusinessProcess
ЗавершитьРаботу=ExitApplication
ЗавершитьРедактированиеМакета=EndTemplateEditing
ЗависимоеСвойство=DependentProperty
ЗависимостиДополнительныхРеквизитов=AdditionalAttributesDependencies
ЗависимостиОбъектаМетаданных=MetadataObjectDependencies
ЗависимостиПравДоступа=AccessRightsDependencies
ЗависимостьРеквизитов=AttributesDependency
ЗависшиеЗадачи=HungTasks
Заголовок=Title
ЗаголовокГруппировкиОтчетаОДвиженияхДокументаШрифт=DocumentRecordsReportGroupHeadingFont
ЗаголовокДелаЦвет=ToDoListTitleColor
ЗаголовокСистемы=SystemTitle
ЗаголовокУдаленногоРеквизитаФон=DeletedAttributeTitleBackground
ЗаголовокУдаленногоРеквизитаШрифт=DeletedAttributeTitleFont
ЗаголовокФормыВыбораЗначения=ValueChoiceFormTitle
ЗаголовокФормыЗначения=ValueFormTitle
ЗагружаетсяИзИнтернета=ImportingFromInternet
ЗагружатьДанныеВРежимеОбмена=ImportDataInExchangeMode
ЗагрузитьДанныеВИнформационнуюБазу=ImportDataToInfobase
ЗагрузитьКомплектПравил=ImportRulesSet
ЗагрузитьКурсыВалют=ImportCurrenciesRates
ЗагрузитьПравилаКонвертацииОбъектов=ImportObjectConvertionRules
ЗагрузитьПравилаРегистрацииОбъектов=ImportObjectRegistrationRules
ЗагрузитьПравилаСинхронизацииДанных=ImportDataSyncRules
ЗагрузитьРасширенияИзменяющиеСтруктуруДанных=LoadExtensionsThatChangeDataStructure
ЗагрузитьСообщениеОбменаДанными=LoadDataExchangeMessage
ЗагрузитьЧастьФайла=ImportFilePart
ЗагрузкаДанных=DataImport
ЗагрузкаДанныхEnterpriseData=EnterpriseDataLoading
ЗагрузкаДанныхВыполняетсяВоВнешнемСоединении=DataImportExecutedInExternalConnection
ЗагрузкаДанныхВыполняетсяЧерезВнешнееСоединение=DataImportedOverExternalConnection
ЗагрузкаДанныхИзФайла=ImportDataFromFile
ЗагрузкаДанныхИзФайлаКлиент=ImportDataFromFileClient
ЗагрузкаДанныхИзФайлаКлиентСервер=ImportDataFromFileClientServer
ЗагрузкаДанныхИзФайлаПереопределяемый=ImportDataFromFileOverridable
ЗагрузкаИзИнтернета=DownloadFromInternet
ЗагрузкаНастроекXDTO=XDTOSettingsImport
ЗагрузкаПравилРегистрацииОбъектов=ObjectsRegistrationRulesImport
ЗадаватьВопросПриЗагрузкеДанныхПриОткрытииОбработки=RequestConfirmationOnDataImportOnOpenDataProcessor
Задание=Job
Задания=Jobs
ЗаданПорядокВыполнения=ExecutionOrderSpecified
ЗадачаИсполнителя=PerformerTask
ЗадачаИсточник=SourceTask
Задачи=Tasks
ЗадачиИстекающиеНаДату=ExpiringTasksOnDate
ЗадачиПоБизнесПроцессу=TasksByBusinessProcess
ЗадачиПоПредмету=TasksBySubject
ЗакладкиВзаимодействий=InteractionsTabs
Заключение=ClosingStatement
ЗакончитьРедактированиеФайла=EndFileEditing
Закрепить=Pin
ЗаменаИОбъединениеЭлементов=ReplaceAndMergeItems
ЗаменаЭлементов=ItemsReplacement
ЗаменяемыеКоманды=CommandsToReplace
ЗамерыВремени=TimeMeasurements
ЗамерыВремениТехнологические=TimeMeasurementsTechnological
ЗамерыКомментарииСтатистики=MeasurementsStatisticsComments
ЗамерыОбластиСтатистики=MeasurementsStatisticsAreas
ЗамерыОперацииСтатистики=MeasurementsStatisticsOperations
ЗамерыСтатистики=StatisticsMeasurements
Заметка=Note
Заметки=Notes
ЗаметкиПользователя=UserNotes
ЗаметкиПользователяСлужебный=UserNotesInternal
ЗаметкиПоПредмету=SubjectNotes
ЗанятьФайл=LockFile
ЗаписатьВерсиюОбъекта=WriteObjectVersion
ЗаписатьВСписокБизнесПроцессов=WriteToBusinessProcessesList
ЗаписатьЗависимыеНаборыЗначенийДоступа=WriteDependentAccessValuesSets
ЗаписатьНаборыЗначенийДоступа=WriteAccessValuesSets
ЗаписыватьВИнформационнуюБазуТолькоИзмененныеОбъекты=WriteToInfobaseOnlyChangedObjects
ЗаписыватьРегистрыНаборамиЗаписей=WriteRegistersAsRecordSets
ЗаписьЧитаемых=DataToReadWriter
ЗапланированноеВзаимодействие=PlannedInteraction
ЗапланированноеВзаимодействиеПрисоединенныеФайлы=PlannedInteractionAttachedFiles
ЗапланироватьВзаимодействиеПоКонтакту=PlanInteractionByContact
ЗапланироватьВзаимодействиеПоПредмету=PlanInteractionBySubject
ЗапланироватьВстречуПоКонтакту=PlanMeetingByContact
ЗапланироватьВстречуПоПредмету=PlanMeetingBySubject
ЗапланироватьВыполнениеОбменаДанными=ScheduleDataExchangeExecution
ЗаполнениеДанныхДляОграниченияДоступа=DataFillingForAccessRestriction
ЗаполнениеОбъекта=ObjectFilling
ЗаполнениеОбъектов=ObjectsFilling
ЗаполнениеОбъектовПереопределяемый=ObjectsFillingOverridable
ЗаполнениеФормы=FillingForm
ЗаполнитьЗначениеРеквизитаУпорядочивания=FillOrderingAttributeValue
ЗаполнитьКонтактнуюИнформацию=FillContactInformation
ЗаполнитьНаборыЗначенийДоступаТабличныхЧастей=FillAccessValuesSetsForTabularSections
ЗаполнитьНаборыЗначенийДоступаТабличныхЧастейДокументов=FillDocumentsTabularSectionsAccessValueSets
ЗаполнитьПроизвольныеПараметры=FillArbitraryParameters
ЗаполнитьФорму=FillForm
ЗаполнятьАвтоматически=AutoFill
ЗаполнятьОбязательно=RequiredToFill
ЗаПоследниеТриМесяца=LastThreeMonths
ЗаПоследниеШестьМесяцев=LastSixMonths
ЗаПоследнийГод=LastYear
ЗаПоследнийМесяц=LastMonth
ЗаПоследнююНеделю=LastWeek
ЗапрашиватьПередТемКакОтправитьУведомление=AskBeforeSendReadReceipt
ЗапретитьИспользованиеУдаляемыхОбъектовВДокументах=ProhibitUsageOfObjectsToDeleteInDocuments
ЗапретитьИспользованиеУдаляемыхОбъектовВКонстантах=ProhibitUsageOfObjectsToDeleteInConstants
ЗапретитьИспользованиеУдаляемыхОбъектовВНаборахЗаписей=ProhibitUsageOfObjectsToDeleteInRecordSets
ЗапретитьИспользованиеУдаляемыхОбъектовВНаборахРегистровРасчета=ProhibitUsageOfObjectsToDeleteInCalculationRegistersSets
ЗапретитьИспользованиеУдаляемыхОбъектовВОбъектах=ProhibitUsageOfObjectsToDeleteInObjects
ЗапретитьОтображениеНебезопасногоСодержимогоВПисьмах=DenyDisplayingUnsafeContentInEmails
ЗапретитьПометкуУдаленияПредопределенныхЭлементов=DenySettingDeletionMarksToPredefinedItems
ЗапретитьРаботуПользователей=DisableUserAuthorisation
ЗапретитьРаботуРегламентныхЗаданий=DisableScheduledJobs
ЗапретитьРедактированиеПользователем=DenyEditingByUser
ЗапретитьУдалениеПредопределенныхЭлементов=DenyDeletingPredefinedItems
ЗапретРедактированияРеквизитовОбъектов=ObjectAttributesLock
ЗапретРедактированияРеквизитовОбъектовКлиент=ObjectAttributesLockClient
ЗапретРедактированияРеквизитовОбъектовПереопределяемый=ObjectAttributesLockOverridable
ЗапретРедактированияРеквизитовОбъектовСлужебный=ObjectAttributesLockInternal
ЗапретРедактированияРеквизитовОбъектовСлужебныйКлиент=ObjectAttributesLockInternalClient
ЗапрещатьЗагрузкуФайловПоРасширению=DenyUploadFilesByExtension
ЗапрещенноеПравоДоступа=ProhibitedAccessRight
ЗапросАдминистрирования=AdministrationRequest
ЗапросНаОтправкуОтчетовОбОшибках=RequestForSendingErrorReports
ЗапросНаСборИОтправкуОтчетовОбОшибках=RequestForErrorReportsCollectionAndSending
ЗапросыРазрешенийНаИспользованиеВнешнихРесурсов=RequestsForPermissionsToUseExternalResources
ЗапускAutomation=StartAutomation
ЗапускатьИВПодчиненномУзлеРИБСФильтрами=RunAlsoInSubordinateDIBNodeWithFilters
ЗапускатьТолькоВГлавномУзле=ExecuteInMasterNodeOnly
ЗапускВебКлиента=StartWebClient
ЗапускВнешнегоСоединения=StartExternalConnection
ЗапускДополнительныхОбработок=StartingAdditionalDataProcessors
ЗапускМобильногоКлиента=StartMobileClient
ЗапускТолстогоКлиента=StartThickClient
ЗапускТонкогоКлиента=StartThinClient
ЗарегистрированыИзмененияДанных=DataChangesRecorded
ЗарегистрироватьИзмененияВсехДанныхКромеСправочников=RecordAllDataChangesButCatalogChanges
ЗарегистрироватьИзмененияОбщихДанныхУзлов=RegisterCommonNodesDataChanges
ЗарегистрироватьИзмененияТолькоСправочников=RecordOnlyCatalogChanges
ЗарегистрироватьИзмененияФильтровОграниченияМиграцииДанных=RegisterDataMigrationRestrictionFiltersChanges
ЗаставкаВнешнейОперации=ExternalOperationSplash
ЗаставкаВосстановления=RecoverySplash
ЗаставкаОбновленияКонфигурации=ConfigurationUpdateSplash
ЗаставкаРезервногоКопирования=BackupSplash
Зашифрован=Encrypted
ЗашифрованныйОбъект=EncryptedObject
ЗаявлениеНаВыпускСертификатаЗаголовокКлючевогоПоляШрифт=CertificateIssueRequestKeyFieldTitleFont
ЗаявлениеНаВыпускСертификатаКлюча=ApplicationForKeyCertificateIssue
Зеленый=Green
ЗнакВопросаСправа=AsQuestionMark
ЗнакСтоп=StopSign
ЗнакСтопЧБ=StopSignBW
Значение=Value
Значение1=Value1
Значение10=Value10
Значение2=Value2
Значение3=Value3
Значение4=Value4
Значение5=Value5
Значение6=Value6
Значение7=Value7
Значение8=Value8
Значение9=Value9
ЗначениеБезГрупп=ValueWithoutGroups
ЗначениеВЕдиницахИзмерения=ValueInUOMs
ЗначениеДоступа=AccessValue
ЗначениеДоступаОбъект=AccessValueObject
ЗначениеИнформационнойБазы=InfobaseValue
ЗначениеОперации=OperationValue
ЗначениеПустойСсылки=EmptyRefValue
ЗначениеРазрешено=ValueAllowed
ЗначениеСвойства=PropertyValue
ЗначенияГруппДоступа=AccessGroupsValues
ЗначенияГруппДоступаПоУмолчанию=DefaultAccessGroupsValues
ЗначенияДоступа=AccessValues
ЗначенияОтборовНезависимогоРегистра=IndependentRegisterFiltersValues
ЗначенияПолей=FieldValues
ЗначенияСвойствОбъектов=ObjectsPropertiesValues
ЗначенияСвойствОбъектовИерархия=ObjectPropertyValueHierarchy
ЗначокЗаставкиВнешнейОперации=ExternalOperationSplashIcon
ЗначокЩита=ShieldIcon
ИгнорироватьПроблему=IgnoreIssue
Идеально=Ideal
Идентификатор=Id
ИдентификаторВладельца=OwnerID
ИдентификаторДляФормул=IDForFormulas
ИдентификаторЗадания=JobID
ИдентификаторЗаписи=RecordID
ИдентификаторЗапроса=QueryID
ИдентификаторИнформационнойБазы=InfoBaseID
ИдентификаторИнформационнойБазыИсточника=SourceInfobaseID
ИдентификаторИнформационнойБазыПриемника=DestinationInfobaseID
ИдентификаторКоманды=CommandID
ИдентификаторКомментария=CommentID
ИдентификаторНаСервере=IDAtServer
ИдентификаторОбласти=AreaID
ИдентификаторОбластиСтатистики=StatisticsAreaID
ИдентификаторОбъекта=ObjectID
ИдентификаторОперации=OperationID
ИдентификаторОснования=BasisID
ИдентификаторПользователяИБ=IBUserID
ИдентификаторПользователяСервиса=ServiceUserID
ИдентификаторПоставляемыхДанных=SuppliedDataID
ИдентификаторПотока=ThreadID
ИдентификаторПрограммногоМодуля=ModuleID
ИдентификаторРегламентногоЗадания=ScheduledJobID
ИдентификаторСеанса=SessionID
ИдентификаторСообщения=MessageID
ИдентификаторСообщенияОтправкаIMAP=MessageIDIMAPSending
ИдентификаторУдаления=DeletionID
ИдентификаторыОбъектовВерсийРасширений=ExtensionVersionObjectIDs
ИдентификаторыОбъектовМетаданных=MetadataObjectIDs
ИдентификаторыОбъектовРасширений=ExtensionObjectIDs
ИдентификаторыОснований=BasisIDs
ИдентификаторыПолученныхЭлектронныхПисем=ReceivedEmailIDs
ИдентификаторыТаблицСОтдельнымиНастройкамиПрав=IDsOfTablesWithIndividualRightsSettings
ИДФайлаЭлектронногоПисьма=EmailFileID
ИерархическийСписок=HierarchicalList
ИерархияВзаимодействийКонтакт=InteractionsHierarchyContact
ИерархияВзаимодействийПредмет=InteractionsHierarchySubject
ИзвлекатьТекстыФайловНаСервере=ExtractTextFilesOnServer
Извлечен=Extracted
ИзвлечениеТекста=TextExtraction
ИзвлечьНеУдалось=FailedExtraction
Изменен=Changed
Изменение=Update
ИзменениеВыполнениеЗадач=EditCompleteTask
ИзменениеДополнительныхСведений=EditAdditionalInfo
ИзменениеМакетовПечатныхФорм=EditPrintFormTemplates
ИзменениеНастройкиСвойства=EditPropertySettings
ИзменениеСостоянийОригиналовПервичныхДокументов=SourceDocumentsOriginalsStatesChange
ИзменениеУчастниковГруппДоступа=EditAccessGroupMembers
ИзмененияОбщихДанныхУзлов=CommonNodeDataChanges
ИзмененноеЗначениеРеквизитаФон=ModifiedAttributeValueBackground
ИзмененноеЗначениеРеквизитаЦвет=ModifiedAttributeValueColor
ИзмененоПользователем=ChangedByUser
Изменил=ChangedBy
Изменить=Change
ИзменитьШрифт=ChangeFont
ИзменяемыеОбъекты=ObjectsToChange
ИзменятьВТранзакции=ChangeInTransaction
ИзменятьЗаданияЗаднимЧислом=ChangeJobsBackdated
ИмпортЗамеровПроизводительности=ImportPerformanceMeasurements
Имя=Name
ИмяАрхива=ArchiveName
ИмяБиблиотеки=LibraryName
ИмяВложение=NameAttachment
ИмяВременногоКаталогаСообщенийОбмена=TempExchangeMessagesDirectoryName
ИмяВременногоФайлаОбработчиковСобытий=EventHandlersTempFileName
ИмяВременногоФайлаПротоколаОбмена=ExchangeProtocolTempFileName
ИмяГруппы=GroupName
ИмяИнформационнойБазыНаСервереДляПодключения=InfobaseToConnectNameOnServer
ИмяКаталогаРезервнойКопииИБ=IBBackupDirectoryName
ИмяКомпьютера=ComputerName
ИмяМакета=TemplateName
ИмяМакетаПравил=RulesTemplateName
ИмяМакетаПравилКорреспондента=CorrespondentRulesTemplateName
ИмяОбработчика=HandlerName
ИмяОбъекта=ObjectName
ИмяОсновногоСерверногоМодуля=MainServerModuleName
ИмяПараметра=ParameterName
ИмяПланаОбмена=ExchangePlanName
ИмяПланаОбменаВРО=ExchangePlanNameSOR
ИмяПланаОбменаДляЗагрузки=ExchangePlanNameForImport
ИмяПланаОбменаИзПравил=ExchangePlanNameFromRules
ИмяПланаОбменаКорреспондента=CorrespondentExchangePlanName
ИмяПодсистемы=SubsystemName
ИмяПользователя=UserName
ИмяПоля=FieldName
ИмяПредопределенногоВида=PredefinedKindName
ИмяПредопределенногоНабора=PredefinedSetName
ИмяПрограммы=ApplicationName
ИмяРасширения=ExtensionName
ИмяРеквизитаИсточника=SourceAttributeName
ИмяСвойства=PropertyName
ИмяСервераИнформационнойБазыДляПодключения=InfobaseToConnectServerName
ИмяТаблицыПриемника=DestinationTableName
ИмяТипаОбъектаТаблицыИсточника=SourceTableObjectTypeName
ИмяФайла=FileName
ИмяФайлаВнешнейОбработкиОбработчиковСобытий=EventHandlerExternalDataProcessorFileName
ИмяФайлаВнешнейОбработкиОтладкиВыгрузки=ExportDebugExternalDataProcessorFileName
ИмяФайлаВнешнейОбработкиОтладкиЗагрузки=ImportDebugExternalDataProcessorFileName
ИмяФайлаНастроекСинхронизацииДанных=DataSyncSettingsFileName
ИмяФайлаНастроекСинхронизацииДанныхДляЗагрузки=DataForImportSyncSettingsFileName
ИмяФайлаОбмена=ExchangeFileName
ИмяФайлаОбновления=UpdateFileName
ИмяФайлаОбработкиДляОтладкиВыгрузки=ExportDebuggingDataProcessorFileName
ИмяФайлаОбработкиДляОтладкиЗагрузки=ImportDebuggingDataProcessorFileName
ИмяФайлаОбработчиковСобытий=EventHandlersFileName
ИмяФайлаПодписи=SignatureFileName
ИмяФайлаПравил=RulesFileName
ИмяФайлаПравилОбмена=ExchangeRulesFileName
ИмяФайлаПротоколаОбмена=ExchangeProtocolFileName
ИмяФайлаПротоколаОбменаЗагрузка=ImportExchangeLogFileName
ИмяФайлаСообщения=MessageFileName
ИмяФайлаСообщенияОбмена=ExchangeMessageFileName
ИмяХеш=NameHash
ИндексКартинки=PictureIndex
ИндикацияХодаОбновленияИБ=IBUpdateProgressIndicator
ИндикацияХодаОтложенногоОбновленияИБ=DeferredIBUpdateProgressIndicator
ИнициализацияЗапросаРазрешений=PermissionsRequestInitialization
ИнструкцияДляУстановкиКодаДляПредопределенногоУзла_ru=InstructionToSetCodeForPredefinedNode_en
ИнструкцияКакВыполнитьУстановкуОбновленияВручную=ManualUpdateInstruction
ИнструкцияПоНастройкеАРМ=SWSetupInstruction
ИнструкцияПоСозданиюФаксимильнойПодписиИПечати=GuideToCreateFacsimileAndStamp
ИнтеграцияПодсистемБСП=SSLSubsystemsIntegration
ИнтеграцияПодсистемБСПКлиент=SSLSubsystemsIntegrationClient
ИнтеграцияПодсистемБСПКлиентПовтИсп=SSLSubsystemsIntegrationClientCached
ИнтеграцияПодсистемБСППовтИсп=SSLSubsystemsIntegrationCached
ИнтерактивнаяПометкаУдаления=InteractiveDeletionMark
ИнтерактивнаяПроверкаЗаполненияКонтактнойИнформации=ContactInformationFillingInteractiveCheck
ИнтерактивнаяПроверкаЗаполненияСвойств=PropertiesFillingInteractiveCheck
ИнтерактивноеИзменениеВыгрузки=InteractiveExportChange
ИнтерактивноеОткрытиеВнешнихОтчетовИОбработок=InteractiveOpenExtReportsAndDataProcessors
ИнтервалВремениНапоминания=ReminderInterval
Интервью=Interview
Интервьюер=Interviewer
ИнтернетПоддержкаИСервисы=InternetSupportAndServices
ИнтерфейсOData=ODataInterface
ИнтерфейсODataСлужебный=ODataInterfaceInternal
ИнтерфейсODataСлужебныйПовтИсп=ODataInterfaceInternalCached
Информация=Information
Информация32=Information32
ИнформацияНеразделенногоПользователя=SharedUserInfo
ИнформацияОбОшибке=ErrorInfo
ИнформацияООшибке=ErrorInformation
ИнформацияОПравилах=RulesInformation
ИнформацияПоНедоступнымПолям=UnavailableFieldsInformation
ИнформацияПриЗапуске=InformationOnStart
ИнформацияПриЗапускеКлиент=InformationOnStartClient
ИнформацияПриЗапускеПереопределяемый=InformationOnStartOverridable
ИнформацияСтатистики=StatisticsInformation
Исключен=Excluded
ИсполнителиЗадач=TaskPerformers
ИсполнителиРоли=RolePerformers
ИсполнителиРолиСОбъектомАдресации=PerformersOfRoleWithAddressingObject
Исполнитель=Performer
ИспользованиеДополнительныхОтчетовИОбработокСервисаВАвтономномРабочемМесте=UseAdditionalReportsAndServiceProcessorsAtStandaloneWorkstation
ИспользованиеКаталогаДополнительныхОтчетовИОбработокВМоделиСервиса=AdditionalReportAndDataProcessorFolderUsageSaaS
ИспользованиеМакета=TemplateUsage
ИспользованиеОбработкиТекущиеДела=UseCurrentToDosProcessor
ИспользованиеПоставляемыхДополнительныхОтчетовИОбработокВОбластяхДанных=UseSuppliedAdditionalReportsAndProcessorsInDataAreas
ИспользованиеУниверсальногоОтчета=UseUniversalReport
ИспользованныеПароли=PreviousPasswords
ИспользоватьFTPРесурс=UseFTPResource
ИспользоватьАвтономнуюРаботуВЛокальномРежиме=UseStandaloneModeInLocalMode
ИспользоватьАвтономнуюРаботуВМоделиСервиса=UseOfflineModeSaaS
ИспользоватьАльтернативныйСерверДляЗагрузкиКурсовВалют=UseAlternativeServerToImportCurrencyRates
ИспользоватьАнкетирование=UseSurvey
ИспользоватьБизнесПроцессыИЗадачи=UseBusinessProcessesAndTasks
ИспользоватьВерсионированиеОбъекта=UseObjectVersioning
ИспользоватьВерсионированиеОбъектов=UseObjectsVersioning
ИспользоватьВнешнихПользователей=UseExternalUsers
ИспользоватьВременныйКаталогДляОтправкиИПриемаСообщений=UseTempDirectoryToSendAndReceiveMessages
ИспользоватьГруппыПользователей=UseUserGroups
ИспользоватьДатуИВремяВСрокахЗадач=UseDateAndTimeInTaskDeadlines
ИспользоватьДатуНачалаЗадач=UseTaskStartDate
ИспользоватьДатыЗапретаЗагрузки=UseImportForbidDates
ИспользоватьДатыЗапретаИзменения=UsePeriodClosingDates
ИспользоватьДляОтправки=UseForSending
ИспользоватьДляПолучения=UseForReceiving
ИспользоватьДляФормыОбъекта=UseForObjectForm
ИспользоватьДляФормыСписка=UseForListForm
ИспользоватьДополнительныеОбработкиСозданияСвязанныхОбъектов=UseAdditionalDataProcessorsForRelatedObjectCreation
ИспользоватьДополнительныеОтчетыИОбработки=UseAdditionalReportsAndDataProcessors
ИспользоватьДополнительныеРеквизитыИСведения=UseAdditionalAttributesAndInfo
ИспользоватьДополнительныйЯзык1=UseAdditionalLanguage1
ИспользоватьДополнительныйЯзык2=UseAdditionalLanguage2
ИспользоватьЗаметки=UseNotes
ИспользоватьЗаполнениеОбъекта=UseObjectFilling
ИспользоватьЗащищенноеСоединениеДляВходящейПочты=UseSecureConnectionForIncomingMail
ИспользоватьЗащищенноеСоединениеДляИсходящейПочты=UseSecureConnectionForOutgoingMail
ИспользоватьНапоминанияПользователя=UseUserReminders
ИспользоватьНесколькоПроизводственныхКалендарей=UseMultipleBusinessCalendars
ИспользоватьОнлайнПоддержку=UseOnlineSupport
ИспользоватьОтборПоДатеДляВсехОбъектов=UseFilterByDateForAllObjects
ИспользоватьОтправкуSMSВШаблонахСообщений=UseSMSMessagesSendingInMessageTemplates
ИспользоватьОтчеты=UseReports
ИспользоватьПапку=UseFolder
ИспользоватьПараметрыТранспортаCOM=UseTransportParametersCOM
ИспользоватьПараметрыТранспортаEMAIL=UseTransportParametersEMAIL
ИспользоватьПараметрыТранспортаFILE=UseTransportParametersFILE
ИспользоватьПараметрыТранспортаFTP=UseTransportParametersFTP
ИспользоватьПодчиненныеБизнесПроцессы=UseSubordinateBusinessProcesses
ИспользоватьПолнотекстовыйПоиск=UseFullTextSearch
ИспользоватьПользовательскийМакет=UseUserTemplate
ИспользоватьПоставляемыйМакет=UseSuppliedTemplate
ИспользоватьПочтовыйКлиент=UseEmailClient
ИспользоватьПредварительныйПросмотр=UsePreview
ИспользоватьПрефиксыДляНастройкиОбмена=UsePrefixesForExchangeSettings
ИспользоватьПрефиксыДляНастройкиОбменаКорреспондента=UsePrefixesForCorrespondentExchangeSettings
ИспользоватьПризнакРассмотрено=UseReviewedFlag
ИспользоватьПрофилиБезопасностиДляДОО=UseSecurityProfilesForARDP
ИспользоватьПрочиеВзаимодействия=UseOtherInteractions
ИспользоватьРазделениеПоОбластямДанных=UseSeparationByDataAreas
ИспользоватьРегламентноеЗадание=UseScheduledJob
ИспользоватьСервисПереводаТекста=UseTextTranslationService
ИспользоватьСетевойКаталог=UseNetworkDirectory
ИспользоватьСинхронизациюДанных=UseDataSynchronization
ИспользоватьСинхронизациюДанныхВЛокальномРежиме=UseDataSynchronizationInLocalMode
ИспользоватьСинхронизациюДанныхВМоделиСервиса=UseDataSynchronizationSaaS
ИспользоватьСинхронизациюДанныхВМоделиСервисаСЛокальнойПрограммой=UseDataSynchronizationSaaSWithLocalApplication
ИспользоватьСинхронизациюДанныхВМоделиСервисаСПриложениемВИнтернете=UseDataSynchronizationSaaSWithWebApplication
ИспользоватьСинхронизациюФайлов=UseFileSync
ИспользоватьСозданиеСвязанныхОбъектов=UseRelatedObjectCreation
ИспользоватьТранзакции=UseTransactions
ИспользоватьТранзакцииПриВыгрузкеДляПлановОбмена=UseTransactionsOnExportForExchangePlans
ИспользоватьУдалениеПомеченныхОбъектов=UseMarkedObjectsDeletion
ИспользоватьУчетОригиналовПервичныхДокументов=UseSourceDocumentsOriginalsRecording
ИспользоватьФильтрВыборочнойРегистрацииОбъектов=UseSelectiveObjectRegistrationFilter
ИспользоватьШаблоныСообщений=UseMessageTemplates
ИспользоватьШифрование=UseEncryption
ИспользоватьЭлектроннуюПочту=UseEmail
ИспользоватьЭлектроннуюПочтуВШаблонахСообщений=UseEmailInMessageTemplates
ИспользоватьЭлектронныеПодписи=UseDigitalSignature
ИспользуемаяОбработка=DataProcessorToUse
ИспользуемыеВидыДоступа=UsedAccessKinds
ИспользуемыеВидыДоступаПоТаблицам=UsedAccessKindsByTables
ИспользуемыеВнешниеРесурсы=ExternalResourcesInUse
Используется=Used
ИспользуетсяБезОбъектовАдресации=UsedWithoutAddressingObjects
ИспользуетсяСОбъектамиАдресации=UsedByAddressingObjects
ИспользуетХранилищеВариантов=UseOptionStorage
ИспользуютсяДопРеквизиты=AdditionalAttributesUsed
ИспользуютсяДопСведения=AdditionalInfoUsed
ИспользуютсяПрофилиБезопасности=UseSecurityProfiles
ИсправлениеВидовКонтактнойИнформации=ContactInformationKindsCorrection
ИсправлениеУстаревшихАдресов=ObsoleteAddressesCorrection
ИсправлятьУстаревшиеАдреса=CorrectObsoleteAddresses
Истина=True
ИсторияВерсий=VersionsHistory
ИсторияИзменений=ChangeHistory
ИсторияКонтактнойИнформации=ContactInformationHistory
Источник=Source
ИсточникВыгрузки=ExportSource
ИсточникИндексКартинки=SourcePictureIndex
ИсточникиПравилДляОбменаДанными=DataExchangeRulesSources
ИсточникПоле1=SourceField1
ИсточникПоле2=SourceField2
ИсточникПоле3=SourceField3
ИсточникПоле4=SourceField4
ИсточникПоле5=SourceField5
ИсточникПравил=RulesSource
ИсточникТекста=TextSource
ИсходныйЯзык=SourceLanguage
Исходящее=Outgoing
Исходящие=Outbox
ИтерацияЗапуска=StartIteration
ИтогиФонГруппы=TotalsGroupBackground
КакСвязаться=HowToContact
КакУстановитьИлиОбновитьВерсиюПлатформы1СПредприятие=HowToInstallOrUpdate1CEnterprisePlatfomVersion
Календари=Calendars
КалендарныеГрафики=CalendarSchedules
КалендарныеГрафикиПереопределяемый=CalendarSchedulesOverridable
КалендарныеГрафикиСлужебный=CalendarSchedulesInternal
Календарь=Calendar
КартаМаршрутаБизнесПроцесса=BusinessProcessFlowchart
КартинкиПисьмаВФорматеHTML=EmailPicturesInHTMLFormat
КаталогSRC=SRCDirectory
КаталогИнформационнойБазыДляПодключения=InfobaseToConnectDirectory
КаталогОбменаИнформацией=DataExchangeDirectory
КаталогСообщенийОбменаДаннымиДляLinux=DataExchangeMessageDirectoryForLinux
КаталогСообщенийОбменаДаннымиДляWindows=DataExchangeMessageDirectoryForWindows
КаталогСРезервнымиКопиями=BackupDirectory
Квартал=Quarter
КемВыдан=IssuedBy
КлассификаторБанков=BankClassifier
КлассификаторОшибокКриптографии=CryptoErrorsClassifier
Ключ=Key
КлючВарианта=VariantKey
КлючДанныхПовторногоИспользования=CachedDataKey
КлючДоступа=AccessKey
КлючДоступаВнешнихПользователей=ExternalUsersAccessKey
КлючДоступаПользователей=UsersAccessKey
КлючеваяОперация=KeyOperation
КлючевыеОперации=KeyOperations
КлючевыеОперацииПрофиля=ProfileKeyOperations
КлючевыеСлова=Keywords
КлючЗамеров=MeasurementsKey
КлючиДоступа=AccessKeys
КлючиДоступаВнешнихПользователей=ExternalUsersAccessKeys
КлючиДоступаГруппДоступа=AccessGroupsAccessKeys
КлючиДоступаКОбъектам=AccessKeysForObjects
КлючиДоступаКРегистрам=AccessKeysForRegisters
КлючиДоступаКРегиструРезультатыПроверкиУчета=AccessKeysToRegisterAccountingCheckResults
КлючиДоступаНаборовГруппДоступа=AccessGroupSetsAccessKeys
КлючиДоступаПользователей=UsersAccessKeys
КлючОбъектаМетаданных=MetadataObjectKey
КлючПользовательскойНастройки=UserSettingKey
КлючРазрешения=PermissionKey
КлючСообщенияЖурналаРегистрации=EventLogMessageKey
КлючУникальности=UniqueKey
КодАльфа2=CodeAlpha2
КодАльфа3=CodeAlpha3
КодДляРазблокировки=UnlockCode
КодЗадачиПланировщика=SchedulerTaskCode
Кодировка=Encoding
КодировкаФайлаПротоколаОбмена=ExchangeProtocolFileEncoding
КодировкиФайлов=FilesEncoding
КодНовогоУзлаВторойБазы=SecondInfobaseNewNodeCode
КодПредопределенногоУзла=PredefinedNodeCode
КодТипаРезервногоКопирования=BackupTypeCode
КодУзла=NodeCode
КодУзлаКорреспондента=CorrespondentNodeCode
КодЯзыка=LanguageCode
Количество=Count
КоличествоДнейВГрафикеСНачалаГода=DaysCountInScheduleSinceBegOfYear
КоличествоЗамеровВПакетеЭкспорта=MeasurementsCountInExportPackage
КоличествоЗначений=ValuesCount
КоличествоКопий=CopiesCount
КоличествоНеРассмотрено=NotReviewedInteractionsCount
КоличествоОбработанныхОбъектовДляОбновленияСтатуса=ProcessedObjectsCountToUpdateStatus
КоличествоОбъектовВИсточнике=ObjectCountInSource
КоличествоОбъектовВПриемнике=ObjectCountInDestination
КоличествоОбъектовКЗагрузкеВнешнееСоединение=ObjectsToImportCountExternalConnection
КоличествоОбъектовНаТранзакцию=ObjectCountPerTransaction
КоличествоОбъектовНесопоставленных=UnmappedObjectsCount
КоличествоОбъектовСопоставленных=MappedObjectCount
КоличествоПопыток=AttemptsNumber
КоличествоПотоковОбновленияДоступа=AccessUpdateThreadsCount
КоличествоПотоковОбновленияИнформационнойБазы=InfobaseUpdateThreadCount
КоличествоРассмотрено=ReviewedItemCount
КоличествоРеквизитов=AttributesCount
КоличествоСведений=InfoCount
КоличествоУникальныхКомментариев=UniqueCommentsCount
КоличествоЭлементовВТранзакции=TransactionItemsCount
КоличествоЭлементовВТранзакцииВыгрузкиДанных=DataExportTransactionItemsCount
КоличествоЭлементовВТранзакцииЗагрузкиДанных=DataImportTransactionItemCount
КоличествоЭлементовВТранзакцииПриВыгрузкеДляПлановОбмена=TransactionItemsCountOnExportForExchangePlans
КоллекцияВажностьПроблемВеденияУчета=AccountingIssuesSeverityCollection
КоллекцияВариантыВажности=SeverityOptionsCollection
КоллекцияВидыАктивныхПользователей=ActiveUsersTypesCollection
КоллекцияВидыСобытийЖурналаРегистрации=EventLogEventKindCollection
КоллекцияДеревоАнкеты=QuestionnaireTreeCollection
КоллекцияДляПомеченныхНаУдалениеОбъектов=ObjectsMarkedForDeletionCollection
КоллекцияДоступныеАнкеты=AvailableQuestionnaireCollection
КоллекцияЗадачиИБизнесПроцессы=TaskAndBusinessProcessCollection
КоллекцияЗаметки=NotesCollection
КоллекцияКартинокСопоставлениеОбъектов=ObjectMappingClipArt
КоллекцияНапоминания=ReminderCollection
КоллекцияОбъектыМетаданных=MetadataObjectsCollection
КоллекцияПиктограммНаличиеОригиналаПервичногоДокумента=IconsCollectionSourceDocumentOriginalAvailable
КоллекцияПиктограммПараметрыШаблонаСообщения=IconCollectionMessageTemplateParameters
КоллекцияПиктограммПечатныеФормыОригиналаПервичногоДокумента=IconsCollectionSourceDocumentOriginalPrintForms
КоллекцияПиктограммФайлов=FileIconCollection
КоллекцияПиктограммЭлементов=ItemIconsCollection
КоллекцияСкрепка=ClipCollection
КомандаПомощникаНастройкиСинхронизацииВажнаяШрифт=SynchronizationSetupWizardCommandImportantFont
КомандаПомощникаНастройкиСинхронизацииОбычнаяШрифт=SynchronizationSetupWizardCommandStandardFont
Команды=Commands
КомментарииОперацииСтатистики=StatisticsOperationComments
КомментарииСтатистики=StatisticsComments
Комментарий=Comment
Комментарий1=Comment1
Комментарий2=Comment2
КомментарийЗамераВремени=TimeMeasurementComment
КомментарийПриВыгрузкеДанных=CommentOnDataExport
КомментарийПриЗагрузкеДанных=CommentOnDataImport
КомментарийСтатистики=StatisticsComment
КомментарийЯзык1=CommentLanguage1
КомментарийЯзык2=CommentLanguage2
Комплексный=Complex
КомпонентаExtraCryptoAPI_3_0_1_26=ComponentExtraCryptoAPI_3_0_1_26
КомпонентаTWAIN=TwainComponent
КомпонентаПечатиQRКода=QRCodePrintingComponent
КомпонентаПечатиШтрихкодов=BarcodePrintingAddIn
КомпонентаПоискаСтрок=StringSearchAddIn
КомпонентыОбмена=ExchangeComponents
КомпоновщикНастроек=SettingsComposer
КомпоновщикОтбораВсехДокументов=AllDocumentsFilterComposer
КомпьютерКлиент=ComputerClient
КомпьютерСервер=ComputerServer
КомуВыдан=IssuedTo
КомуВыданСертификат=CertificateOwner
КонвертацияОбъектовXDTO=ConvertXTDOObjects
КонвертацияОбъектовИнформационныхБаз=InfobaseObjectConversion
КонвертацияОбъектовРаспределенныхИнформационныхБаз=DistributedInfobasesObjectsConversion
КонецБлокировки=LockEnd
КонечнаяТочкаКорреспондента=CorrespondentEndpoint
КонечнаяТочкаОбменаСообщениями=MessagesQueueEndpoint
КоннекторВерхНиз=ConnectorTopBottom
КоннекторВерхПраво=ConnectorTopRight
КоннекторВерхПравоНиз=ConnectorTopRightBottom
КоннекторЛевоНизПраво=ConnectorLeftBottomRight
КоннекторЛевоПраво=ConnectorLeftRight
КоннекторПравоНиз=ConnectorRightBottom
КонструкторФормул=FormulasConstructor
КонструкторФормулКлиент=FormulasConstructorClient
КонструкторФормулКлиентСервер=FormulasConstructorClientServer
КонструкторФормулСлужебный=FormulasConstructorInternal
Контакт=Contact
КонтактВзаимодействия=InteractionContact
КонтактнаяИнформация=ContactInformation
КонтактнаяИнформацияНеактуально=ContactInformationObsolete
КонтактнаяИнформацияОбработкаПроверкиЗаполнения=ContactInformationValidationProcessing
КонтактнаяИнформацияПерейтиПоСсылке=ContactInformationGoToURL
КонтактнаяИнформацияСРедактированиемВДиалогеЦвет=ContactInformationEditedInDialogColor
КонтактыВзаимодействий=InteractionsContacts
Контекст=Context
КонтекстнаяНастройкаОтчета=ContextReportSetting
КонтекстнаяПодсказка=AsTooltip
КонтекстПроверокВеденияУчета=AccountingChecksContext
КонтролироватьСовместимостьСВерсиямиКонфигурации=ControlCompatibilityWithConfigurationVersions
КонтрольАктивностиПользователей=MonitorUserActivities
КонтрольВеденияУчета=AccountingAudit
КонтрольВеденияУчетаВызовСервера=AccountingAuditServerCall
КонтрольВеденияУчетаГлобальный=AccountingAuditGlobal
КонтрольВеденияУчетаКлиент=AccountingAuditClient
КонтрольВеденияУчетаПереопределяемый=AccountingAuditOverridable
КонтрольВеденияУчетаСлужебный=AccountingAuditInternal
КонтрольВеденияУчетаСлужебныйКлиент=AccountingAuditInternalClient
КонтрольВеденияУчетаСлужебныйПовтИсп=AccountingAuditInternalCached
КонтрольДинамическогоОбновления=DynamicUpdateControl
КонтрольнаяСумма=Checksum
КонтрольНеразделенныхНаборовЗаписейПриЗаписи=CheckSharedRecordsSetsOnWrite
КонтрольНеразделенныхОбъектовПриЗаписи=CheckSharedObjectsOnWrite
КонфигурацияПоддерживаетБСП=ConfigurationSupportsSSL
КонфликтыОбработчиков=HandlersConflicts
КопированиеНастроекПользователей=CopyUsersSettings
КорневаяПапка=RootDirectory
Корреспондент=Peer
КоррСчет=CorrAccount
Красный=Red
КраткоеПредставление=BriefPresentation
Кратность=Repetition
Курс=Rate
КурсВалюты=CurrencyExchangeRate
КурсивноеНачертание=Italics
КурсыВалют=ExchangeRates
КэшПереводов=TranslationCache
КэшПрограммныхИнтерфейсов=ProgramInterfaceCache
ЛегальностьПолученияОбновлений=LegitimateSoftware
ЛимитПроблем=IssuesLimit
Личная=Personal
ЛичныеРассылки=PersonalMailings
Ложь=False
Макет=Template
МакетКонфигурации=ConfigurationTemplate
МакетОтветившие=AnsweredTemplate
МакетОтветы=AnswersTemplate
МакетОтчета=ReportTemplate
МакетОтчетаПоОшибкамВЖурналеРегистрации=EvengLogErrorReportTemplate
МакетФайлаЗагрузкаИБ=LoadIBFileTemplate
МакетФайлаОбновленияКонфигурации=ConfigurationUpdateFileTemplate
МакетФайлаРезервногоКопирования=BackupFileTemplate
МакетыПечатныхФорм=PrintFormTemplates
МаксимальноеЗначение=MaxValue
МаксимальныйРазмер=MaximumSize
МаксимальныйРазмерФайла=MaxFileSize
МаксимальныйРазмерФайлаОбластиДанных=MaxDataAreaFileSize
Максимум=Max
МаскаНомераТелефона=PhoneNumberMask
МастерАнкетыПоРазделам=QuestionnaireBySectionWizard
МеждународноеНаименование=InternationalDescription
МеждународныйФорматАдреса=InternationalAddressFormat
МенюДополнительныеФункции=MenuAdditionalFunctions
МестаИспользованияСсылок=SearchForReferences
МестоПроведенияВстречи=MeetingPlace
МестоХраненияФункциональныхОпций=FunctionalOptionsStorage
Месяц=Month
МинимальноДопустимыйУровень=MinValidLevel
МинимальноеЗначение=MinValue
МинимальныйИнтервалРегламентныхЗаданийДОИОВМоделиСервиса=MinimalARADPScheduledJobIntervalSaaS
Минимум=Min
Многопоточный=Multithreaded
МногострочноеПолеВвода=MultilineInputField
Модификатор=Modifier
МожноИзменятьСпособРедактирования=CanChangeEditMethod
МоиБизнесПроцессы=MyBusinessProcesses
МоиВариантыОтчетовЦвет=MyReportsOptionsColor
МоиЗадачи=MyTasks
МоиЗадачиДляРабочегоСтола=MyTasksForDesktop
МоиЗаметки=MyNotes
МоиЗаметкиПоПредмету=MyNotesOnSubject
МоиНапоминания=MyReminders
МониторингЗадач=TaskMonitoring
МониторСинхронизацииДанныхВМоделиСервиса=DataSynchronizationMonitorSaaS
Монопольно=Exclusively
Монохромное=Monochrome
Мультиязычность=NationalLanguageSupport
МультиязычностьКлиент=NationalLanguageSupportClient
МультиязычностьКлиентСервер=NationalLanguageSupportClientServer
МультиязычностьПереопределяемый=NationalLanguageSupportOverridable
МультиязычностьПовтИсп=NationalLanguageSupportCached
МультиязычностьСервер=NativeLanguagesSupportServer
НаборГруппДоступа=AccessGroupsSet
НаборСвойств=PropertiesSet
НаборыГруппДоступа=SetsOfAccessGroups
НаборыДополнительныхРеквизитовИСведений=AdditionalAttributesAndInfoSets
НаборыЗначенийДоступа=AccessValuesSets
Назначение=Purpose
НазначениеДополнительныхОбработок=AdditionalDataProcessorsPurposes
НазначениеОпросов=PollPurpose
Наименование=Description
НаименованиеАвтономногоРабочегоМеста=StandaloneWorkstationDescription
НаименованиеВторойБазы=SecondInfobaseDescription
НаименованиеПолное=DescriptionFull
НаименованиеЭтойБазы=ThisInfobaseDescription
НаименованиеЯзык1=DescriptionLanguage1
НаименованиеЯзык2=DescriptionLanguage2
НаименованияПараметровИОтборов=FilterParameterDescriptions
НаименованияПолей=FieldDescriptions
НаличиеФайлов=FilesExist
НаписатьSMS=WriteSMS
НаписатьSMSПоКонтакту=WriteSMSMessageByContact
НаписатьSMSПоПредмету=WriteSMSMessageBySubject
НаписатьЭлектронноеПисьмоПоКонтакту=WriteEmailByContact
НаписатьЭлектронноеПисьмоПоПредмету=WriteEmailBySubject
Напоминание=Reminder
НапоминаниеПриРедактировании=ReminderOnEdit
НапоминанияПользователей=UsersReminders
НапоминанияПользователя=UserReminders
НапоминанияПользователяВызовСервера=UserRemindersServerCall
НапоминанияПользователяГлобальный=UserRemindersGlobal
НапоминанияПользователяКлиент=UserRemindersClient
НапоминанияПользователяКлиентПовтИсп=UserRemindersClientCached
НапоминанияПользователяКлиентСервер=UserRemindersClientServer
НапоминанияПользователяПереопределяемый=UserRemindersOverridable
НапоминанияПользователяСлужебный=UserRemindersInternal
Напомнить=Remind
НаправлениеСортировки=SortDirection
НаПроверке=OnValidation
НаследованиеНастроекПравОбъектов=ObjectRightsSettingsInheritance
НаследованиеРазрешено=InheritanceIsAllowed
Наследовать=Inherit
НастроитьПрава=SetRights
НастроитьСостоянияОригиналаПервичногоДокумента=ConfigureSourceDocumentOriginalStates
НастройкаАвтоматическогоСопоставления=AutomaticMappingSetting
НастройкаАвтоматическойЗагрузкиДанных=AutomaticDataImportSetup
НастройкаАвторегистрацияДвижений=RegisterRecordAutoRecordSetting
НастройкаАвторегистрацияПоследовательностей=SequenceAutoRecordSetting
НастройкаАдресВнешнейОбработкиЗапросов=QueryExternalDataProcessorAddressSetting
НастройкаВариантНомераСообщения=MessageNumberOptionSetting
НастройкаЗавершена=SettingCompleted
НастройкаИОценкаПроизводительности=PerformanceSetupAndMonitoring
НастройкаИспользованияСтандартногоИнтерфейсаOData=StandardODataInterfaceUsageSetup
НастройкаКолонтитулов=HeaderAndFooterSettings
НастройкаКомандПечати=PrintCommandsSetup
НастройкаКонтрольВыгрузкиОбъектов=ObjectExportControlSetting
НастройкаМоихОтчетовИОбработок=MyReportsAndDataProcessorsSettings
НастройкаНаСторонеСервиса=SetupSaaS
НастройкаОнлайнПоддержки=OnlineSupportSetting
НастройкаОтложенногоСтартаПроцесса=DeferredProcessStartSetup
НастройкаОтправкиSMS=OutboundSMSSettings
НастройкаОтправкиОтчетовОбОшибках=ErrorsReportsSendingSettings
НастройкаПереводаТекста=TextTranslationSetting
НастройкаПодключения=ConnectionSetup
НастройкаПодключенияКСервису=SaaSConnectionSetup
НастройкаПодчиненногоУзлаРИБЗавершена=SubordinateDIBNodeSetupCompleted
НастройкаПолейТаблицы=TableFieldSetup
НастройкаПолейТаблицыСопоставления=MappingFieldTableSetup
НастройкаПорядкаЭлементов=ItemOrderSetup
НастройкаПорядкаЭлементовСлужебный=ItemOrderSetupInternal
НастройкаПроксиСервера=ProxyServerSetting
НастройкаРабочегоКаталога=WorkingDirectorySettings
НастройкаРазрешенийНаИспользованиеВнешнихРесурсов=ExternalResourcePermissionSetup
НастройкаРазрешенийНаИспользованиеВнешнихРесурсовВызовСервера=PermissionsToUseExternalResourcesSetupServerCall
НастройкаРазрешенийНаИспользованиеВнешнихРесурсовГлобальный=ExternalResourcePermissionSetupGlobal
НастройкаРазрешенийНаИспользованиеВнешнихРесурсовКлиент=ExternalResourcePermissionSetupClient
НастройкаРасписанияОбменовДанными=DataExchangesScheduleSetup
НастройкаРезервногоКопирования=BackupSetup
НастройкаРезервногоКопированияИБ=IBBackupSetup
НастройкаРезервногоКопированияКлиентСервер=BackupSetupClientServer
НастройкаРезервнойКопии=BackupCreationSetup
НастройкаСинхронизации=SyncSetup
НастройкаСинхронизацииФайлов=FilesSynchronizationSetup
НастройкаСистемнойУчетнойЗаписиЭлектроннойПочты=SystemEmailAccountSetup
НастройкаСканирования=ScanningSettings
НастройкаСканированияНаСеанс=SetupScanningForSession
НастройкаСортировки=SortingSetup
НастройкаСтандартногоИнтерфейсаOData=SetUpStandardODataInterface
НастройкаТекущихДел=CustomizeCurrentUserTasks
Настройки=Settings
НастройкиВариантовОтчетов=ReportOptionsSettings
НастройкиВерсионированияОбъектов=ObjectVersioningSettings
НастройкиВходаПользователей=UserAuthorizationSettings
НастройкиИспользованияПрофилейБезопасности=SecurityProfileSetup
НастройкиКолонтитулов=HeaderOrFooterSettings
НастройкиКомандПечати=PrintCommandsSettings
НастройкиКорреспондента=CorrespondentSettings
НастройкиОбмена=ExchangeSettings
НастройкиОбменаДаннымиXDTO=XDTODataExchangeSettings
НастройкиОценкиПроизводительности=PerformanceMonitorSettings
НастройкиОчисткиФайлов=FilesClearingSettings
НастройкиПодключения=ConnectionSettings
НастройкиПодчиненногоУзлаРИБ=SubordinateDIBNodeSettings
НастройкиПользователей=UsersSettings
НастройкиПользователейИПрав=UsersAndRightsSettings
НастройкиПользователя=UserSettings
НастройкиПравОбъектов=ObjectsRightsSettings
НастройкиПрограммы=ApplicationSettings
НастройкиПрограммыПереопределяемый=ApplicationSettingsOverridable
НастройкиРаботыСПочтой=EmailOperationSettings
НастройкиРаботыСФайлами=FilesOperationSettings
НастройкиСинхронизацииДанных=DataSyncSettings
НастройкиСинхронизацииДанныхВМоделиСервиса=DataSynchronizationSettingsSaaS
НастройкиСинхронизацииФайлов=FileSynchronizationSettings
НастройкиСообщенийИзДругихПрограмм=SettingsOfMessagesFromOtherApplications
НастройкиСтандартногоИнтерфейсаOData=StandardODataInterfaceSettings
НастройкиТранспортаОбменаДанными=DataExchangeTransportSettings
НастройкиТранспортаОбменаОбластейДанных=DataAreasExchangeTransportSettings
НастройкиТранспортаОбменаОбластиДанных=DataAreaExchangeTransportSettings
НастройкиУдаленияОбъектов=ObjectsDeletionSettings
НастройкиУчетныхЗаписейЭлектроннойПочты=EmailAccountSettings
НастройкиХраненияИстории=HistoryStorageSettings
НастройкиЦентраМониторинга=MonitoringCenterSettings
НастройкиЭлектроннойПодписиИШифрования=DigitalSignatureAndEncryptionSettings
Наценка=Markup
НаценкаНаКурсДругойВалюты=MarkupForOtherCurrencyRate
НачалоБлокировки=LockStart
НачалоДействияБлокировки=LockEffectiveFrom
НачальнаяВыгрузкаДанных=InitialDataExport
НачальноеЗаполнение=InitialFilling
НачальныйОбразСоздан=InitialImageCreated
НачатьИнтервью=StartInterview
НаЧтение=ForReading
НеВерсионировать=DontVersionize
НеВыводитьНикакихИнформационныхСообщенийПользователю=DontOutputInfoMessagesToUser
НеВыгружать=DoNotExport
НеВыгружатьОбъектыПоСсылкам=DontExportObjectsByRefs
НеВыполнялся=WasNotExecuted
Недействителен=Invalid
Неделя=Week
НеДоставлено=NotDelivered
НежелательнаяПочта=JunkMail
НезавершившаясяПроверка=CheckInProgress
НезависимоеИспользованиеДополнительныхОтчетовИОбработокВМоделиСервиса=IndependentUsageOfAdditionalReportsAndDataProcessorsSaaS
НеЗадаватьВопросПриЗагрузкеДанныхПриОткрытииОбработки=DontRequestConfirmationOnDataImportOnOpenDataProcessor
НеЗадано=NotDefined
НезаполненныеРеквизиты=BlankAttributes
НеИзвлечен=NotExtracted
НеинтерактивноеОбновлениеКонфигурации=NonInteractiveConfigurationUpdate
НеИспользоватьВоВстроенномПочтовомКлиенте=NotUseInDefaultEmailClient
НеИспользоватьРазделениеПоОбластямДанных=DoNotUseSeparationByDataAreas
НеИспользуетсяС=NotUsedSince
НеОпознаноПровайдером=UnidentifiedByProvider
Неопределено=Undefined
НеОстанавливатьПоОшибке=NotStopByMistake
НеОтправленоПровайдером=NotSentByProvider
НеОчищать=DontClear
НепосредственноеЧтениеВИБПриемнике=DirectReadingInDestinationIB
НепринятаяВерсия=UnacceptedVersion
НепринятыеВложения=PendingAttachments
НепринятыеДанныеПоКоллизии=RejectedConflictData
НеПринятыеКИсполнениюЗадачи=NotAcceptedForExecutionTasks
НепринятыеКОбработкеПочтовымСерверомИсходящиеПисьма=OutgoingMailNotAcceptedByMailServer
НепринятыйПоДатеЗапретаОбъектНеСуществуетВБазе=RejectedDueToPeriodEndClosingDateObjectDoesNotExistInInfobase
НепринятыйПоДатеЗапретаОбъектСуществуетВБазе=RejectedDueToPeriodEndClosingDateObjectExistsInInfobase
НепроведенныйДокумент=UnpostedDocument
Нерабочий=Nonworking
НерабочийПериодПроизводственногоКалендаряФон=BusinessCalendarNonWorkPeriodBackground
НеразделенныеПользователи=SharedUsers
НерекомендуемаяВерсияПлатформы=PlatformUpdateRecommended
НесколькоВариантовИз=MultipleOptionsFor
НеСтартованныйБизнесПроцесс=NotStartedBusinessProcess
НетГраницы=NoBorder
НетПоворота=NoRotation
НеудаленныеОбъекты=NotDeletedObjects
НеУдалосьПередатьПровайдеру=CannotPassToProvider
Низкая=Low
НикогдаНеОтправлятьУведомление=NeverSendReadReceipt
НоваяОчередь=NewQueue
НоваяСинхронизацияДанных=NewDataSynchronization
НоваяСсылка=NewRef
НоваяСтрока=NewRow
Новый=New
НовыйКодПредопределенногоУзла=NewPredefinedNodeCode
НовыйНаборГруппДоступа=NewAccessGroupsSet
НовыйНаборГруппПользователей=NewUserGroupsSet
НовыйПароль=NewPassword
НомераОтсканированныхФайлов=ScannedFilesNumbers
НомераСообщенийУзлаПланаОбмена=ExchangePlanNodeMessageNumbers
НомерВерсии=VersionNumber
НомерДляОтправки=SendingNumber
НомерДня=DayNumber
НомерДокумента=DocumentNumber
НомерИтерации=IterationNumber
НомерКартинкиПодписанЗашифрован=SignedEncryptedPictureNumber
НомерНабора=SetNumber
НомерОтправленного=SentNo
НомерОтправленногоНачальнаяВыгрузкаДанных=SentNumberInitialDataExport
НомерПакета=PackageNumber
НомерПериода=PeriodNumber
НомерСеанса=SessionNumber
НомерСообщения=MessageNo
НомерТелефона=PhoneNumber
НомерТелефонаБезКодов=PhoneNumberWithoutCodes
НомерЯчейки=CellNumber
ОбластиСтатистики=StatisticsAreas
ОбластьДанныхВспомогательныеДанные=DataAreaAuxiliaryData
ОбластьДанныхЗначение=DataAreaValue
ОбластьДанныхИспользование=DataAreaUsage
ОбластьДанныхОсновныеДанные=DataAreaMainData
ОбластьПоискаДублей=DuplicatesSearchArea
ОбластьСтатистики=StatisticsArea
ОбменДанными=DataExchange
ОбменДаннымиXDTOСервер=DataExchangeXDTOServer
ОбменДаннымиВМоделиСервиса=DataExchangeSaaS
ОбменДаннымиВМоделиСервисаКлиент=DataExchangeSaaSClient
ОбменДаннымиВМоделиСервисаПереопределяемый=DataExchangeSaaSOverridable
ОбменДаннымиВМоделиСервисаПовтИсп=DataExchangeSaaSCached
ОбменДаннымиВнешнееСоединение=DataExchangeExternalConnection
ОбменДаннымиВызовСервера=DataExchangeServerCall
ОбменДаннымиГлобальный=DataExchangeGlobal
ОбменДаннымиКлиент=DataExchangeClient
ОбменДаннымиКонтроль=DataExchangeControl
ОбменДаннымиПереопределяемый=DataExchangeOverridable
ОбменДаннымиПовтИсп=DataExchangeCached
ОбменДаннымиСервер=DataExchangeServer
ОбменДаннымиСлужебный=DataExchangeInternal
ОбменДаннымиСобытия=DataExchangeEvents
ОбменДаннымиУправление=DataExchangeManagement
ОбменДаннымиУправление_3_0_1_1=DataExchangeManagement_3_0_1_1
ОбновитьВерсиюДатЗапретаИзмененияПослеЗагрузкиДанных=UpdatePeriodClosingDatesVersionAfterImportData
ОбновитьВнешнегоПользователя=UpdateExternalUser
ОбновитьГруппыВладельцевНастроекПрав=UpdateRightsSettingsOwnersGroups
ОбновитьГруппыЗначенийДоступа=UpdateAccessValuesGroups
ОбновитьЗначенияГруппДоступа=UpdateAccessGroupsValues
ОбновитьКонтактнуюИнформацию=UpdateContactInformation
ОбновитьНастройкиОбменаДанными=UpdateDataExchangeSettings
ОбновитьСостояниеБизнесПроцесса=UpdateBusinessProcessState
ОбновитьФайлИзФайлаНаДиске=UpdateFileFromFileOnHardDrive
Обновление=RefreshEnabled
ОбновлениеАгрегатов=UpdateAggregates
ОбновлениеВерсииДатЗапретаИзмененияПослеЗагрузкиДанных=PeriodClosingDatesVersionUpdateAfterDataImport
ОбновлениеВерсииИБ=IBVersionUpdate
ОбновлениеВерсииИБВМоделиСервиса=IBVersionUpdateSaaS
ОбновлениеВерсииИБПередУдалениемСсылочногоОбъекта=IBVersionUpdateBeforeDeleteRefObject
ОбновлениеВерсииКонфигурации=ConfigurationVersionUpdate
ОбновлениеВнешнихКомпонентССайта=AddInsUpdateFromWebsite
ОбновлениеДляНеполноправногоПользователя=UpdateForLimitedUser
ОбновлениеДоступаНаУровнеЗаписей=AccessUpdateOnRecordsLevel
ОбновлениеДоступаРучноеУправление=AccessUpdateManualControl
ОбновлениеИндексаППД=FullTextSearchIndexUpdate
ОбновлениеИнформационнойБазы=InfobaseUpdate
ОбновлениеИнформационнойБазыБСП=InfobaseUpdateSSL
ОбновлениеИнформационнойБазыВызовСервера=InfobaseUpdateServerCall
ОбновлениеИнформационнойБазыГлобальный=InfobaseUpdateGlobal
ОбновлениеИнформационнойБазыКлиент=InfobaseUpdateClient
ОбновлениеИнформационнойБазыКлиентПереопределяемый=InfobaseUpdateClientOverridable
ОбновлениеИнформационнойБазыПереопределяемый=InfobaseUpdateOverridable
ОбновлениеИнформационнойБазыСлужебный=InfobaseUpdateInternal
ОбновлениеИнформационнойБазыСлужебныйВМоделиСервиса=InfobaseUpdateInternalSaaS
ОбновлениеИнформационнойБазыСлужебныйВызовСервера=InfobaseUpdateInternalServerCall
ОбновлениеИнформационнойБазыСлужебныйПовтИсп=InfobaseUpdateInternalCached
ОбновлениеКлючейДоступаКДанным=DataAccessKeysUpdate
ОбновлениеКлючейДоступаПользователей=UsersAccessKeysUpdate
ОбновлениеКлючейДоступаТекущиеЗадания=UsersAccessKeysCurrentJobs
ОбновлениеКомпонентСПортала1СИТС=ComponentsUpdateFrom1CITSPortal
ОбновлениеКонфигурации=ConfigurationUpdate
ОбновлениеКонфигурацииБазыДанных=UpdateDataBaseConfiguration
ОбновлениеКонфигурацииВызовСервера=ConfigurationUpdateServerCall
ОбновлениеКонфигурацииКлиент=ConfigurationUpdateClient
ОбновлениеНеПодходит=IncompatibleUpdate
ОбновлениеПредопределенныхВариантовОтчетов=PredefinedReportOptionsUpdate
ОбновлениеСтатусовДоставкиSMS=SMSDeliveryStatusUpdate
ОбновлятьСПортала1СИТС=UpdateFrom1CITSPortal
ОбрабатываемыеДанные=DataToProcess
ОбработкаПисемВыполняетсяВДругомПочтовомКлиенте=MailHandlingInOtherMailClient
ОбработкаПолученияФормыПользователяДляНеразделенныхПользователей=ProcessGetUserFormForSharedUsers
ОбработкаПорцииЗавершена=BatchProcessingCompleted
ОбработкаПредупрежденийКоллизии=ConflictWarningsProcessing
ОбработкаПредупрежденийПоДатеЗапретаЗагрузки=WarningsProcessingByImportRestrictionDate
ОбработкаПредупрежденийПроведения=PostingWarningsProcessing
ОбработкаПроверкиЗаполненияПрисоединенногоФайла=ProcessAttachedFileFillingCheck
ОбработкаСервисовИнтеграции=IntegrationServicesProcessing
ОбработкиНастройкиВыгрузки=ExportSettingsDataProcessors
ОбработкиНастройкиЗагрузки=ImportSettingsDataProcessors
Обработчик=Handler
Обработчик2=Handler2
ОбработчикиОбновления=UpdateHandlers
ОбработчикиОбновленияОбщихДанных=SharedDataUpdateHandlers
ОбработчикиСобытийСинхронизацииДанных=DataSyncEventHandlers
ОбработчикиСобытийЧитаемИзФайлаПравилОбмена=ReadEventHandlersFromExchangeRulesFile
ОбработчикПисатель=WriterHandler
ОбработчикЧитательИлиПисатель2=ReadOrWriteHandler2
ОбразецНастройкиКолонтитуловЦвет=HeadersAndFootersSettingsPreviewColor
ОбразецНастройкиКолонтитуловШрифт=HeaderOrFooterSettingsPreviewFont
ОбрезатьСтрокиСправа=RemoveTrailingSpaces
Обслуживание=SupportAndService
Обсуждения=Conversations
ОбсужденияКлиент=ConversationsClient
ОбсужденияСлужебный=ConversationsInternal
ОбсужденияСлужебныйВызовСервера=ConversationsInternalServerCall
ОбсужденияСлужебныйКлиент=ConversationsInternalClient
ОбсужденияСлужебныйКлиентСервер=ConversationsInternalClientServer
ОбщаяПроизводительностьСистемы=OverallSystemPerformance
ОбщегоНазначения=Common
ОбщегоНазначенияВызовСервера=CommonServerCall
ОбщегоНазначенияГлобальный=CommonGlobal
ОбщегоНазначенияКлиент=CommonClient
ОбщегоНазначенияКлиентПереопределяемый=CommonClientOverridable
ОбщегоНазначенияКлиентПовтИсп=CommonClientCached
ОбщегоНазначенияКлиентСервер=CommonClientServer
ОбщегоНазначенияПереопределяемый=CommonOverridable
ОбщегоНазначенияСлужебныйКлиент=CommonInternalClient
ОбщегоНазначенияСлужебныйКлиентСервер=CommonInternalClientServer
ОбщееСостояние=OverallState
ОбщиеВнешниеКомпоненты=CommonAddIns
ОбщиеДанные=SharedData
ОбщиеНастройки=CommonSettings
ОбщиеНастройкиУзловИнформационныхБаз=CommonInfobasesNodesSettings
ОбщиеПараметрыСинхронизации=CommonSynchronizationSettings
ОбщиеПараметрыШаблоновОграниченияДоступа=CommonAccessRestrictionTemplateParameters
ОбщиеПоставляемыеМакетыПечати=CommonSuppliedPrintTemplates
ОбщиеПроцедурыФункции=CommonProceduresFunctions
ОбъединениеЭлементов=ItemsMerge
ОбъединитьЯчейки=MergeCells
Объект=Object
ОбъектАвторизации=AuthorizationObject
ОбъектАдресации=AddressingObject
ОбъектВыгруженПоСсылке=ObjectExportedByRef
ОбъектМетаданных=MetadataObject
ОбъектНазначения=RelatedObject
ОбъектСДополнительнымиКомандами=ObjectWithAdditionalCommands
ОбъектСНастраиваемымПорядком=ObjectWithCustomOrder
ОбъектСУчетомОригиналовПервичныхДокументов=ObjectWithSourceDocumentsOriginalsAccounting
ОбъектСФайлами=ObjectWithFiles
ОбъектыАдресацииЗадач=TaskAddressingObjects
ОбъектыПересечения=IntersectionObjects
ОбъектыПересеченияОбработчика=HandlerIntersectionObjects
ОбъектыПоСсылкеЗагружатьБезПометкиУдаления=ImportReferencedObjectsWithoutDeletionMark
ОбъемНенужныхФайлов=IrrelevantFilesVolume
Обычная=Ordinary
ОбычныйДоступСФлажком=NormalAccessWithCheckBox
ОбычныйТекст=NormalText
ОбязательноеЗаполнение=Mandatory
Обязательный=IsRequired
ОграничениеАвторизации=AuthorizationRestriction_
ОграничениеДоступаНаУровнеЗаписейИспользуется=RecordLevelAccessRestrictionInUse
ОграничениеДоступаНаУровнеЗаписейУниверсально=RecordLevelAccessRestrictionIsUniversal
ОграничениеНаВходВПрограмму=AuthorizationRestriction
ОграничиватьДоступНаУровнеЗаписей=LimitAccessAtRecordLevel
ОграничиватьДоступНаУровнеЗаписейУниверсально=LimitAccessAtRecordLevelUniversally
ОдинВариантИз=OneVariantOf
ОдинКоМногим=OneToMany
ОжидаемаяДлительнаяОперация16=ExpectedTimeConsumingOperation16
ОжидаемаяДлительнаяОперация48=ExpectedTimeConsumingOperation48
ОкончаниеДействияБлокировки=LockEffectiveTo
Оперативно=Seamless
ОперацииАдминистрированияПрофилейБезопасности=SecurityProfileAdministrativeOperations
ОперацииСтатистики=StatisticsOperations
Операция=Operation
ОперацияСтатистики=StatisticsOperation
ОписаниеWebСервиса=WebServiceDetails
ОписаниеДатыЗапрета=PeriodEndClosingDateDetails
ОписаниеИзмененийПрограммы=ApplicationReleaseNotes
ОписаниеМетаданных=MetadataDetails
ОписаниеНовойВозможностиПоВыводуОписаний=DetailsDisplayNewFeatureDetails
ОписаниеОбработчиковОбновления=UpdateHandlersDetails
ОписаниеОшибки=ErrorDescription
Описатель=Specifier
ОповещениеОбОкончанииСрокаДействия=CertificateAboutToExpireNotification
ОпределитьФормуПрисоединенногоФайлаВзаимодействия=DetermineAttachedFileFormInteractions
ОпределитьФормуПрисоединенногоФайлаШаблоныСообщений=DetermineAttachedFileFormMessageTemplates
Опрос=Survey
ОптимизированнаяЗаписьОбъектов=OptimizedObjectsWriting
ОпубликоватьФайл=PublishFile
Оранжевый=Orange
Органайзер=Organizer
Организация=Organization
ОригиналПолучен=OriginalReceived
ОригиналыНеВсе=OriginalsNotAll
ОсвободитьФайл=UnlockFile
Основание=Basis
ОсновнаяВалюта=MainCurrency
ОсновнаяГруппаДоступаПоставляемогоПрофиля=MainSuppliedProfileAccessGroup
ОсновнаяСхемаКомпоновкиДанных=MainDataCompositionSchema
ОсновнаяФорма=DefaultForm
ОсновнойОбъектАдресации=MainAddressingObject
ОсновнойОбъектАдресацииПроверяющий=MainAddressingObjectSupervisor
ОсновнойЭлементСписка=MainListItem
ОсновнойЯзык=DefaultLanguage
ОставлятьКопииСообщенийНаСервере=KeepMessageCopiesAtServer
Остановлен=Suspended
ОтборЖурналаРегистрации=EventLogFilter
ОтборИзменяемыеОбъекты=FilterObjectsToChange
ОтборПредупрежденийПоТипам=WarningsFilterByTypes
ОтборСинхронизаций=SynchronizationsFilter
ОтборЧитаемыеОбъекты=FilterObjectsToRead
Отборы=Filters
Ответ=Response
Ответить=Reply
ОтветитьВсем=ReplyToAll
ОтветитьНаЭлектронноеПисьмо=ReplyEmail
ОтветитьНаЭлектронноеПисьмоВсем=ReplyEmailToAll
Ответственный=EmployeeResponsible
ОтветственныйЗаВедениеПапок=EmployeeResponsibleForFoldersMaintenance
ОтветственныйЗаКонтрольИсполнения=EmployeeResponsibleForTasksManagement
ОтветственныйЗаОбработкуПисем=EmployeeResponsibleForProcessingEmails
ОтветыНаВопросыАнкет=QuestionnaireQuestionAnswers
Отключена=isDisabled
ОтключениеАвтономногоРабочегоМеста=StandaloneWorkstationDisconnection
ОтключениеОбновленияКлючейДоступа=DIsableAccessKeysUpdate
ОтключениеОбсуждений=DisableDiscussions
ОтключениеПроверкиИспользованияУдаляемыхОбъектов=DisableCheckForUsageOfObjectsToDelete
ОтключитьАвтоматическуюСинхронизациюДанных=DisableAutomaticDataSync
ОтключитьИспользованиеПланаОбмена=DisableExchangePlanUsage
ОтключитьРассылкиПередУдалениемТипаПолучателейРассылки=DisableBulkEmailBeforeDeleteBulkEmailRecipientsType
Открепить=Unpin
ОткрыватьКарточку=OpenCard
ОткрыватьПротоколыОбменаПослеВыполненияОпераций=OpenExchangeProtocolsAfterExecutingOperations
ОткрыватьФайл=OpenFile
ОткрытиеВнешнейОбработкиИлиОтчетаСВыборомБезопасногоРежима=OpenExternalDataProcessorOrReportWithSafeModeSelection
ОткрытиеФормы=OpeningForm
ОткрытыйОтвет=OpenAnswer
Открыть=Open
ОткрытьВыбранныйФайл=OpenSelectedFile
ОткрытьМакет=OpenTemplate
ОтладкаОбработчиковВыгрузки=ExportHandlersDebug
ОтладкаОбработчиковЗагрузки=ImportHandlersDebug
Отлично=Excellent
ОтложеннаяЗаписьУзла=DeferredNodeWriting
Отложенно=Deferred
ОтложенноеОбновлениеВГлавномУзлеЗавершеноУспешно=DeferredMasterNodeUpdateCompleted
ОтложенноеОбновлениеЗавершеноУспешно=DeferredUpdateCompletedSuccessfully
ОтложенноеОбновлениеИБ=DeferredIBUpdate
ОтложенноеОбновлениеНеЗавершено=DeferredUpdateNotCompleted
ОтложенныеОбработчики=DeferredHandlers
ОтложенныйБизнесПроцесс=DeferredBusinessProcess
ОтложитьРассмотрениеВзаимодействия=PostponeInteractionReview
ОтмененныеДлительныеОперации=CanceledTimeConsumingOperations
Отменено=Canceled
ОтменитьОтправкуДанныхУзлаВРаспределеннойИнформационнойБазе=CancelSendNodeDataInDistributedInfobase
ОтменитьРедактированиеМакета=CancelTemplateEditing
ОтносительноВремениПредмета=RelativeToSubjectTime
ОтносительноТекущегоВремени=RelativeToCurrentTime
ОтображатьТелоИсходногоПисьма=DisplaySourceEmailBody
Отозван=Revoked
Отпечаток=Thumbprint
Отправитель=Sender
ОтправительАдрес=SenderAddress
ОтправительКонтакт=SenderContact
ОтправительПредставление=SenderPresentation
ОтправитьSMS=SendSMS
ОтправитьПисьмо=SendMail
ОтправитьПолучитьПочту=SendReceiveEmail
ОтправитьЭлектронноеПисьмо=SendEmail
ОтправкаSMS=SendSMSMessage
ОтправкаSMSКлиент=SendSMSMessageClient
ОтправкаSMSКлиентПереопределяемый=SendSMSMessageClientOverridable
ОтправкаSMSПереопределяемый=SendSMSMessageOverridable
ОтправкаSMSПовтИсп=SendSMSMessageCached
ОтправкаКонтактнойИнформации=SendContactInformation
ОтправкаСообщения=SendMessage
Отправленные=SentMessages
Отправлено=Sent
ОтправленоПровайдером=SentByProvider
ОтправляетсяПровайдером=BeingSentByProvider
ОтправлятьВТранслите=SendInTransliteration
ОтправлятьЕслиПустой=SendIfEmpty
ОтправлятьПисьмаВФорматеHTML=SendEmailsInHTMLFormat
ОтправлятьСкрытыеКопииПисемНаЭтотАдрес=SendBCCToThisAddress
Отчество=MiddleName
Отчет=Report
ОтчетКроссТаблица=CrossTableReport
ОтчетОДвиженияхДокумента=DocumentRecordsReport
ОтчетОДвиженияхДокументаПереопределяемый=DocumentRecordsReportOverridable
ОтчетОДвиженияхДокументаСлужебныйКлиент=DocumentRecordsReportInternalClient
ОтчетОСохраненииФайловЭлектронныхПодписей=ReportOnSavingFilesOfDigitalSignatures
ОтчетПоВерсиямОбъекта=ObjectVersionsReport
ОтчетТаблица=TableReport
Отчеты=Reports
ОтчетыКлиент=ReportsClient
ОтчетыКлиентПереопределяемый=ReportsClientOverridable
ОтчетыКлиентСервер=ReportsClientServer
ОтчетыПереопределяемый=ReportsOverridable
ОтчетыСервер=ReportsServer
Оформление=Appearance
ОценкаПроизводительности=PerformanceMonitor
ОценкаПроизводительностиВызовСервера=PerformanceMonitorServerCall
ОценкаПроизводительностиВызовСервераПовтИсп=PerformanceMonitorServerCallCached
ОценкаПроизводительностиГлобальный=PerformanceMonitorGlobal
ОценкаПроизводительностиКлиент=PerformanceMonitorClient
ОценкаПроизводительностиКлиентСервер=PerformanceMonitorClientServer
ОценкаПроизводительностиПериодЗаписи=PerformanceMonitorRecordPeriod
ОценкаПроизводительностиПовтИсп=PerformanceMonitorCached
ОценкаПроизводительностиСлужебный=PerformanceMonitorInternal
Очередь=Queue
ОчередьИзвлеченияТекста=TextExtractionQueue
ОчередьИнсталляцииПоставляемыхДополнительныхОтчетовИОбработокВОбластиДанных=SuppliedAdditionalReportAndDataProcessorInstallationQueueInDataArea
ОчередьОтложеннойОбработки=DeferredProcessingQueue
ОчиститьВерсии=CleanUpVersions
ОчиститьИнформациюОбАвтореВерсии=ClearVersionAuthorInformation
ОчиститьСсылкиНаУзелИнформационнойБазы=ClearRefsToInfobaseNode
ОчиститьФайлы=CleanUpFiles
ОчиститьФайлыИВерсии=CleanUpFilesAndVersions
ОчисткаЗамеровВремени=ClearTimeMeasurements
ОчисткаНастроекПользователей=ClearUsersSettings
ОчисткаНенужныхФайлов=CleanUpUnusedFiles
ОчисткаУстаревшихВерсийОбъектов=ClearingObsoleteObjectVersions
ОчищатьУдаленные=CleanUpDeletedFiles
ОчищатьУдаленныеИНенужные=CleanUpDeletedAndUnusedFiles
Ошибка=Error
Ошибка_ТранспортСообщения=ErrorMessageTransport
Ошибка32=Error32
ОшибкаВыполненияКодаОбработчиковПриОтправкеДанных=HandlersCodeExecutionErrorOnSendData
ОшибкаВыполненияКодаОбработчиковПриПолученииДанных=HandlersCodeExecutionErrorOnGetData
ОшибкаОбращенияКПрограмме=ApplicationCallError
ОшибкаПолнотекстовыйПоискФон=ErrorFullTextSearchBackground
ОшибкаПолученияСтатусаУПровайдера=ErrorOnGetStatusFromProvider
ОшибкаПроверкиСконвертированногоОбъекта=ConvertedObjectValidationError
ОшибкаРасхожденияВерсийПриПолученииДанных=VersionDifferenceErrorOnGetData
ОшибкаУстановкиМонопольногоРежима=ExclusiveModeSettingError
Ошибки=Errors
ПакетыДляОтправки=PackagesToSend
ПакетыИнформацииПриЗапуске=InformationPackagesOnStart
ПанельАдминистрированияБСП=SSLAdministrationPanel
ПанельАдминистрированияБСПВМоделиСервиса=SSLAdministrationPanelSaaS
ПанельДругихОтчетов=OtherReportsPanel
ПанельОтчетов=ReportPanel
ПанельОтчетовАдминистрирование=ReportPanelAdministration
Папка=Folder
ПапкаОблачногоСервиса=CloudServiceFolder
ПапкаЭлектронногоПисьма=EmailMessageFolder
Папки=Folders
ПапкиФайлов=FilesFolders
ПапкиЭлектронныхПисем=EmailMessageFolders
Параллельно=Parallel
Параметры=Parameters
ПараметрыFTP=FTPParameters
ПараметрыАдминистрированияИБ=IBAdministrationParameters
ПараметрыАдминистрированияПрограммы=ApplicationAdministrationParameters
ПараметрыБлокировкиРаботыСВнешнимиРесурсами=ExternalResourceAccessLockParameters
ПараметрыЗадания=JobParameters
ПараметрыИнсталляции=InstallationParameters1
ПараметрыИтоговИАгрегатов=TotalsAndAggregatesParameters
ПараметрыКлиентаНаСервере=ClientParametersAtServer
ПараметрыОбработчикаОбновления=UpdateHandlerParameters
ПараметрыОбработчиков=HandlersParameters
ПараметрыОграниченияДоступа=AccessRestrictionParameters
ПараметрыПодключенияВнешнейСистемы=ExternalSystemConnectionParameters
ПараметрыПроксиСервера=ProxyServerParameters
ПараметрыПрописи=AmountInWordsParameters
ПараметрыПрописиВалюты_en=CurrencyInWordsParameters_en
ПараметрыПрописиВалютыНаДругихЯзыках=CurrencyInWordsInOtherLanguagesParameters
ПараметрыПроцедуры=ProcedureParameters
ПараметрыПроцедурыЗавершения=CompletionProcedureParameters
ПараметрыРаботыВерсийРасширений=ExtensionVersionParameters
ПараметрыРаботыПрограммы=ApplicationRuntimeParameters
ПараметрыРезервногоКопирования=BackupParameters
ПараметрыСеансаСинхронизацииДанных=DataSynchronizationSessionParameters
ПараметрыСинхронизацииДанных=DataSyncParameters
ПараметрыСценарияДополнения=AdditionScenarioParameters
ПараметрыХраненияФайловВИБ=ParametersOfFilesStorageInIB
ПараметрыЦентраМониторинга=MonitoringCenterParameters
ПараметрыЭлектронногоПисьма=EmailMessageParameters
ПаролиСинхронизацииДанных=DataSynchronizationPasswords
ПарольАдминистратора=AdministratorPassword
ПарольАрхиваСообщенияОбмена=ArchivePasswordExchangeMessages
ПарольДляРаспаковкиФайлаОбмена=ExchangeFileUnpackPassword
ПарольДляСжатияФайлаОбмена=ExchangeFileCompressionPassword
ПарольИнформационнойБазыДляПодключения=InfobaseToConnectPassword
ПервичныйДокумент=SourceDocument
ПервичныйДокументПредставление=SourceDocumentPresentation
ПервоеОбновлениеДоступаЗавершилось=FirstAccessUpdateCompleted
Перевод=Translation
ПереводТекста=TextTranslation
ПереводТекстаНаДругиеЯзыки=TextTranslationTool
ПереводТекстаНаДругиеЯзыкиКлиент=TextTranslationToolClient
ПередачаПараметров=PassingParameters
ПередУдалениемПланаОбмена=BeforeDeleteExchangePlan
ПерейтиВПолноэкранныйРежим=SwitchToFullScreen
Переключатель=RadioButton
ПереместитьВЗакладкиВзаимодействия=MoveToBookmarksInteractions
ПереместитьВлевоВверх=MoveUpLeft
ПереместитьВлевоВсе=MoveAllLeft
ПереместитьВПапкуПисем=MoveToEmailFolder
ПереместитьВправоВниз=MoveRightDown
ПереместитьГруппировкуВыше=MoveGroupUp
ПереместитьГруппировкуНиже=MoveGroupDown
ПереместитьКолонкуВлево=MoveColumnLeft
ПереместитьКолонкуВправо=MoveColumnRight
Перенаправить=Forward
ПеренаправитьЗадачи=ForwardTasks
ПереносФайлов=FileTransfer
Переслать=ForwardMail
ПереслатьПисьмоКакВложение=ForwardEmailAsAttachment
ПереслатьЭлектронноеПисьмо=ForwardEmail
ПерестроениеАгрегатов=RebuildAggregates
ПериодЗаписи=RecordPeriod
Периодически=Periodically
ПериодичностиРасписанийРассылокОтчетов=ReportMailingSchedulePeriodicities
ПериодичностьРасписания=SchedulePeriodicity
ПериодОкончание=PeriodEnd
ПериодОтбораВсехДокументов=AllDocumentsFilterPeriod
ПериодОтбораСценарияУзла=NodeScenarioFilterPeriod
ПериодОчистки=ClearingPeriod
ПериодОчисткиФайлов=FilesCleanupPeriod
ПериодХраненияЗамеров=KeepMeasurementsPeriod
ПериодХраненияСообщенийНаСервере=KeepMailAtServerPeriod
ПериодыНерабочихДнейКалендаря=CalendarNonWorkDaysPeriods
Персонализирована=Personalized
ПерсональнаяНастройкаПроксиСервера=ProxyServerCustomSettings
ПечатнаяФорма=PrintForm
ПечатныеФормыИВложения=PrintFormsAndAttachments
ПечатныеФормыОтчетыИОбработки=PrintFormsReportsAndDataProcessors
Печать=Print
ПечатьДокументов=PrintDocuments
ПечатьЭлектронногоПисьма=PrintEmail
ПиктограммыДоступаКНастройкамОтчета=ReportSettingsAccessIcons
ПиктограммыНастроекОтчета=ReportSettingsIcons
ПиктограммыПланОбменаУзел=IconsExchangePlanNode
ПиктограммыТиповДанных=DataTypeIcons
ПиктограммыЭлементов=ItemIcons
ПиктограммыЭлементовСправочникаСостоянияОригиналовПервичныхДокументов=IconsOfSourceDocumentsOriginalsStateCatalogItems
ПисьмаВложения=EmailAttachments
Письмо=MailMessage
ПисьмоВФорматеHTML=HTMLFormatEmail
ПланированиеИзвлеченияТекстаВМоделиСервиса=TextExtractionPlanningSaaS
ПланОбновления=UpdatePlan
Плохо=Bad
ПовторитьЗагрузкуСообщенияОбменаДаннымиПередЗапуском=RetryDataExchangeMessageImportBeforeStart
ПовторнаяЗапись=WriteAgain
ПовторнаяСинхронизацияДанныхПередЗапуском=DataReSyncBeforeStart
ПодборСертификатовДляШифрования=SelectEncryptionCertificates
ПодборЦелевогоВремени=ResponseTimeThresholdMeasurement
ПодборЦелевогоВремениКлючевойОперации=CalculateKeyOperationResponseTimeThreshold
ПодборЯзыкаИзСпискаДоступных=PickLanguageFromAvailableLanguagesList
ПодготовитьДанныеКПолучению=PrepareDataToImport
ПодготовкаНовогоПисьма=ComposeNewMessage
Подготовлен=Prepared
Подготовлена=IsPrepared
ПоддерживаемыеКлиентскиеПриложения=SupportedClientApplications
ПоддерживаемыеОбъектыФормата=SupportedObjectsInFormat
ПодключаемыеКоманды=AttachableCommands
ПодключаемыеКомандыВызовСервера=AttachableCommandsServerCall
ПодключаемыеКомандыКлиент=AttachableCommandsClient
ПодключаемыеКомандыКлиентПовтИсп=AttachableCommandsClientCached
ПодключаемыеКомандыКлиентСервер=AttachableCommandsClientServer
ПодключаемыеКомандыПереопределяемый=AttachableCommandsOverridable
ПодключаемыеКомандыПовтИсп=AttachableCommandsCached
ПодключаемыеОтчетыИОбработки=AttachableReportsAndDataProcessors
ПодключениеОбсуждений=EnableDiscussions
ПодключенныеРасширения=AttachedExtensions
Подменю=Popup
ПодменюСервис=ServiceSubmenu
ПодписанЗашифрованЗаголовок=SignedEncryptedTitle
ПодписанЗашифрованСостояния=SignedEncryptedStatuses
Подписание=Signing
ПодписаниеДанных=DataSigning
ПодписанныйОбъект=SignedObject
ПодписанЭП=SignedWithDS
Подпись=Signature
ПодписьВерна=SignatureCorrect
ПодписьДляНовыхСообщенийПростойТекст=SignatureForNewMessagesPlainText
ПодписьДляНовыхСообщенийФорматированныйДокумент=SignatureForNewMessagesFormattedDocument
ПодписьИПечать=SignatureAndSeal
ПодписьПриОтветеПересылкеПростойТекст=ReplyForwardSignaturePlainText
ПодписьПриОтветеПересылкеФорматированныйДокумент=ReplyForwardSignatureFormattedDocument
Подразделение=Department
Подсистема=Subsystem
Подсистема1=Subsystem1
Подсистема2=Subsystem2
ПодсистемыКонфигурацииПереопределяемый=ConfigurationSubsystemsOverridable
Подсказка=ToolTip
ПодтвердитьПолучениеДанных=ConfirmDataExported
Подтверждено=Accepted
Подчеркивание=Underline
ПодчиненнаяТаблица=SubordinateTable
Позвонить=Call
ПозвонитьИлиОтправитьSMS=CallOrSendSMS
ПозвонитьПоКонтакту=CallByContact
ПозвонитьПоПредмету=CallBySubject
Поиск=Search
ПоискДублей=SearchForDuplicates
ПоискИсполняемогоФайлаОнлайнПоддержки=SearchForExecutableOnlineSupportFile
ПоискИУдалениеДублей=DuplicateObjectsDetection
ПоискИУдалениеДублейКлиент=DuplicateObjectsDetectionClient
ПоискИУдалениеДублейПереопределяемый=DuplicateObjectsDetectionOverridable
ПоискКомпонентыНаПортале1СИТС=SearchForComponentOn1CITSPortal
ПоказатьОтличия=ShowDifferences
ПоказатьРезультатРезервногоКопирования=ShowBackupResult
ПоказатьТолькоВыбранныеРоли=ShowSelectedRolesOnly
ПоказыватьВАрхивеАнкет=ShowInQuestionnaireArchive
ПоказыватьОповещение=ShouldShowUserNotification
ПоказыватьСлужебныеРеквизиты=ShowInternalAttributes
Поле1=Field1
Поле2=Field2
Поле3=Field3
Поле4=Field4
Поле5=Field5
ПолеВвода=InputField
ПолезныйСовет=UsefulTip
ПолезныйСоветКонтрольВеденияУчета=UsefulTipAccountingAudit
ПолеИмяФайлаСообщенияОбмена=ExchangeMessageFileNameField
ПолеРегистраКлючейДоступаКРегистрам=RegisterAccessKeysRegisterField
ПолноеИмя=FullName
ПолноеИмяОбъекта=FullObjectName
ПолноеИмяТипаПараметраВводаНаОсновании=InputOnBasisParameterTypeFullName
ПолноеНаименование=FullDescr
ПолнотекстовыйПоиск=FullTextSearch
ПолнотекстовыйПоискВДанных=FullTextSearchInData
ПолнотекстовыйПоискКлиент=FullTextSearchClient
ПолнотекстовыйПоискСервер=FullTextSearchServer
ПолнотекстовыйПоискСерверПереопределяемый=FullTextSearchServerOverridable
ПолнотекстовыйПоискСлужебныйВызовСервера=FullTextSearchInternalServerCall
ПолнотекстовыйПоискСлужебныйКлиент=FullTextSearchInternalClient
ПолныеПрава=FullAccess
ПолныйПутьLinux=FullPathLinux
ПолныйПутьWindows=FullPathWindows
ПолныйСиноним=FullSynonym
Полугодие=HalfYear
ПолужирноеНачертание=BoldFormatting
Получатели=Recipients
ПолучателиКопий=CCRecipients
ПолучателиОтвета=ReplyRecipients
ПолучателиПисьма=EmailRecipients
ПолучателиРассылки=BulkEmailRecipients
ПолучателиСкрытыхКопий=BccRecipients
Получатель=Recipient
ПолучательРассылки=BulkEmailRecipient
ПолучениеДереваОбработчиковОбновления=GetUpdateHandlersTree
ПолучениеИОтправкаЭлектронныхПисем=SendReceiveEmails
ПолучениеПолейПредставленияВзаимодействия=ReceiveInteractionPresentationFields
ПолучениеПредставленияВзаимодействия=GetInteractionPresentation
ПолучениеФайловИзИнтернета=GetFilesFromInternet
ПолучениеФайловИзИнтернетаКлиент=GetFilesFromInternetClient
ПолучениеФайловИзИнтернетаКлиентСервер=GetFilesFromInternetClientServer
ПолучениеФайловИзИнтернетаСлужебный=GetFilesFromInternetInternal
ПолучениеФайловИзИнтернетаСлужебныйВызовСервера=GetFilesFromInternetInternalServerCall
ПолученоОтправлено=SentReceived
ПолучитьДанныеИнформационнойБазы=GetInfobaseData
ПолучитьЗначениеФункциональнойОпции=GetFunctionalOptionValue
ПолучитьНастройкиСинхронизацииДляДругойПрограммы=GetSynchronizationSettingsForOtherApplication
ПолучитьОбщиеДанныеУзлов=GetCommonNodesData
ПолучитьПараметрыИнформационнойБазы=GetInfobaseParameters
ПолучитьПланыОбменаКонфигурации=GetConfigurationExchangePlans
ПолучитьПоляПредставленияБизнесПроцесса=GetBusinessProcessPresentationFields
ПолучитьПредставлениеБизнесПроцесса=GetBusinessProcessPresentation
ПолучитьРезультатЗагрузкиДанных=GetDataImportResult
ПолучитьРезультатПодготовкиДанныхКВыгрузке=GetPrepareDataToExportResult
ПолучитьСостояниеДлительнойОперации=GetTimeConsumingOperationState
Пользователи=Users
ПользователиВМоделиСервиса=UsersSaaS
ПользователиИнформационнойБазы=InfoBaseUsers
ПользователиКлиент=UsersClient
ПользователиКлиентСервер=UsersClientServer
ПользователиПереопределяемый=UsersOverridable
ПользователиСервиса=ServiceUsers
ПользователиСлужебный=UsersInternal
ПользователиСлужебныйВМоделиСервиса=UsersInternalSaaS
ПользователиСлужебныйВМоделиСервисаВызовСервера=UsersInternalSaaSServerCall
ПользователиСлужебныйВМоделиСервисаКлиент=UsersInternalSaaSClient
ПользователиСлужебныйВМоделиСервисаКлиентСервер=UsersInternalSaaSClientServer
ПользователиСлужебныйВМоделиСервисаПовтИсп=UsersInternalSaaSCached
ПользователиСлужебныйКлиент=UsersInternalClient
ПользователиСлужебныйКлиентСервер=UsersInternalClientServer
ПользователиСлужебныйПовтИсп=UsersInternalCached
Пользователь=User
ПользовательSMTP=SMTPUser
ПользовательБезФотографии=UserWithoutPhoto
ПользовательВыбранный=SelectedUser
ПользовательИнформационнойБазыДляПодключения=InfobaseToConnectUser
ПользовательОповещенОСрокеДействия=UserNotifiedOfExpirationDate
ПользовательскиеМакетыПечати=UserPrintTemplates
ПользовательскиеНастройкиДоступаКОбработкам=DataProcessorAccessUserSettings
ПользовательскиеНастройкиОтчетов=UserReportSettings
Пользовательский=Custom
ПользовательскийМакетУдалить=UserTemplateDelete
ПользовательСтандартногоИнтерфейсаOData=StandardODataInterfaceUser
ПоляИСортировки=FieldsAndOrders
ПоляПоиска=SearchFields
ПоляПоискаТаблицыПриемника=DestinationTableSearchFields
ПоляТаблицы=TableFields
ПоляТаблицыПриемника=DestinationTableFields
Пометка=Check
ПометкаУдаления=DeletionMark
ПомещатьВПапку=PutInFolder
ПомещатьПисьмоВПапкуПисьмаОснования=PutEmailInBaseEmailFolder
ПомощникИнтерактивногоОбменаДанными=InteractiveDataExchangeWizard
ПомощникИнтерактивногоОбменаДаннымиВМоделиСервиса=InteractiveDataExchangeWizardSaaS
ПомощникНастройкиСинхронизацииДанныхМеждуПриложениямиВИнтернете=DataSynchronizationBetweenWebApplicationsSetupWizard
ПомощникНастройкиУчетнойЗаписи=AccountSetupWizard
ПомощникСозданияАвтономногоРабочегоМеста=StandaloneWorkstationCreationWizard
ПомощникСозданияОбменаДанными=DataExchangeCreationWizard
ПоНеделям=ByWeeks
ПоОбщемуРасписанию=ByCommonSchedule
ПоОтдельномуРасписанию=OnSeparateSchedule
ПоПравилу=ByRule
ПортСервераВходящейПочты=IncomingMailServerPort
ПортСервераИсходящейПочты=OutgoingMailServerPort
ПорядковыйНомер=SequenceNumber
ПорядковыйНомерВоВложениях=SequenceNumberInAttachments
Порядок=Order
ПорядокБиблиотеки=LibraryOrder
ПорядокЗаполнения=FillOrder
ПорядокКоллекции=CollectionOrder
ПорядокНастройки=SettingsOrder
ПорядокОбновленияДляКлиентСервернойБазы=ClientServerInfobaseUpdateOrder
ПорядокОбновленияДляФайловойБазы=UpdateProcedureForTheFileBase
ПорядокОбновленияПлатформы=PlatformUpdateOrder
ПорядокОтветовНаЗапросыУведомленийОПрочтении=ReplyToReadReceiptPolicies
ПоследнееОбновлениеДоступа=LastAccessUpdate
ПоследнийЗапуск=LastRun
ПоследнийЗапускЗавершение=LastRunCompletion
ПоследнийЗапускНачало=LastRunStart
ПоследнийИспользуемыйКлиент=LastUsedClient
Последовательно=Sequentially
ПоставляемаяОбработка=SuppliedDataProcessor
ПоставляемыеДополнительныеОтчетыИОбработки=SuppliedAdditionalReportsAndDataProcessors
ПоставляемыеМакетыПечати=SuppliedPrintTemplates
Поставляемый=Supplied
ПоставляемыйПрофильИзменен=SuppliedProfileChanged
ПостроительОтчета=ReportBuilder
ПотокиОбновления=UpdateThreads
ПотребоватьСменуПароляПриВходе=UserMustChangePasswordOnAuthorization
ПоЦикламПроизвольнойДлины=ByArbitraryLengthPeriods
ПояснениеКомментария=CommentNote
ПоясняющийОшибкуТекст=ErrorNoteText
ПоясняющийТекст=NoteText
ПраваДоступа=AccessRights
ПраваДоступаУпрощенно=AccessRightsSimplified
ПраваРолей=RolesRights
ПравилаXML=XMLRules
ПравилаXMLКорреспондента=XMLCorrespondentRules
ПравилаВыборочнойРегистрацииОбъектов=SelectiveObjectsRegistrationRules
ПравилаДляОбменаДанными=DataExchangeRules
ПравилаЗагружены=RulesAreImported
ПравилаЗачитанные=RulesAreRead
ПравилаЗачитанныеКорреспондента=ReadCorrespondentRules
ПравилаКонвертацииОбъектов=ObjectsConversionRules
ПравилаОбработкиЭлектроннойПочты=EmailProcessingRules
ПравилаОтбора=FilterRules
ПравилаПоиска=SearchRules
ПравилаПроверкиУчета=AccountingCheckRules
ПравилаРегистрацииОбъектов=ObjectsRegistrationRules
ПравилоОтбора=FilterRule
ПравилоПроверки=CheckRule
Право=Right
ПравоДобавление=AddRight
ПравоДобавлениеБезОграничения=UnrestrictedAddRight
ПравоЗапрещено=RightIsProhibited
ПравоИзменение=RightUpdate
ПравоИзменениеБезОграничения=UnrestrictedUpdateRight
ПравоИнтерактивноеДобавление=InteractiveAddRight
ПравоНедействительногоПользователяФон=InvalidUserRightBackground
ПравоПросмотр=ViewRight
ПравоПросмотраФон=ViewRightBackground
ПравоРедактирование=EditRight
ПравоРедактированияФон=RightToEditBackground
ПравоСозданияФон=CreateRightBackground
ПравоЧтениеБезОграничения=UnrestrictedReadRight
Праздник=Holiday
ПревьюТабличногоВопросаОтветыВКолонках=TabularQuestionPreviewAnswersInColumns
ПревьюТабличногоВопросаОтветыВСтроках=TabularQuestionPreviewAnswersInRows
ПревьюТабличногоВопросаОтветыСтрокиИКолонки=TabularQuestionPreviewAnswersRowsAndColumns
ПревьюТабличногоВопросаСоставной=TabularQuestionPreviewComposite
Предмет=SubjectOf
ПредметВзаимодействия=InteractionSubject
ПредметЗадачи=TaskSubject
ПредметЗаметок=NotesSubject
ПредметЗаметокОбъект=NotesSubjectObject
ПредметНапоминания=ReminderSubject
ПредметНапоминанияОбъект=ReminderSubjectObject
ПредметСтрокой=SubjectString
ПредметШаблонаСообщения=MessageTemplateSubject
ПредметыПапкиВзаимодействий=InteractionsFolderSubjects
ПредназначенДляSMS=ForSMSMessages
ПредназначенДляВводаНаОсновании=ForInputOnBasis
ПредназначенДляЭлектронныхПисем=ForEmails
ПредопределеннаяПапка=PredefinedFolder
ПредопределенныеВариантыОтчетов=PredefinedReportsOptions
ПредопределенныеВариантыОтчетовВерсийРасширений=PredefinedExtensionsVersionsReportsOptions
ПредопределенныеВариантыОтчетовРасширений=PredefinedExtensionsReportsOptions
ПредопределенныеОтветы=PredefinedAnswers
ПредопределенныеОтветыВКолонках=PredefinedAnswersInColumns
ПредопределенныеОтветыВСтроках=PredefinedAnswersInRows
ПредопределенныеОтветыВСтрокахИКолонках=PredefinedAnswersInRowsAndColumns
ПредопределенныйВариант=PredefinedOption
ПредопределенныйЭлемент=PredefinedItem
Предпраздничный=Preholiday
Представление=Presentation
ПредставлениеВладельца=OwnerPresentation
ПредставлениеИсточника=SourcePresentation
ПредставлениеКонтакта=ContactPresentation
ПредставлениеОбъекта=ObjectPresentation
ПредставлениеОтбора=FilterPresentation
ПредставлениеОтбораСценарияУзла=NodeScenarioFilterPresentation
ПредставлениеПараметра=ParameterPresentation
ПредставлениеПредмета=SubjectPresentation
ПредставлениеПрограммногоМодуля=SoftwareModulePresentation
ПредставлениеТекущейНастройки=CurrentSettingsItemPresentation
Представления=Presentations
ПредставленияРазрешений=PermissionsPresentations
Предупреждение=Warning
Предупреждение_СообщениеОбменаБылоРанееПринято=Warning_ExchangeMessageAlreadyAccepted
Предупреждение32=Warning32
ПредупреждениеБезопасности=SecurityWarning
ПредупреждениеКонвертацииОбъектаПриОтправке=ObjectConversionWarningOnSend
ПредупреждениеНезаполненногоРеквизита=BlankAttributeWarning
ПредупреждениеНепроведенногоДокумента=UnpostedDocumentWarning
ПредупреждениеОКоллизии=ConflictWarning
ПредупреждениеОКопированииНастроек=CopySettingsWarning
ПредупреждениеПоДатеЗапретаЗагрузки=WarningByImportRestrictionDate
ПредупреждениеСинхронизации=SynchronizationWarning
ПредупрежденияОбработчиковОтправкиПолучения=ReceiptSendingHandlersWarnings
ПредупрежденияПриЗавершенииРаботы=ExitWarnings
ПредупрежденияПриСинхронизацииДанных=DataSyncWarnings
ПредупрежденияСинхронизаций=SynchronizationWarnings
Предустановленный=Predefined
ПредыдущаяКонтрольнаяСумма=PreviousCheckSum
ПрерыватьПриОшибке=InterruptOnError
Префикс=Prefix
ПрефиксацияОбъектов=ObjectsPrefixes
ПрефиксацияОбъектовКлиентСервер=ObjectsPrefixesClientServer
ПрефиксацияОбъектовКлиентСерверПереопределяемый=ObjectsPrefixesClientServerOverridable
ПрефиксацияОбъектовПереопределяемый=ObjectsPrefixesOverridable
ПрефиксацияОбъектовПовтИсп=ObjectsPrefixesCached
ПрефиксацияОбъектовСлужебный=ObjectsPrefixesInternal
ПрефиксацияОбъектовСобытия=ObjectsPrefixesEvents
ПрефиксИнформационнойБазы=InfobasePrefix
ПрефиксИнформационнойБазыИсточника=SourceInfobasePrefix
ПрефиксИнформационнойБазыИсточникаУстановлен=SourceInfobasePrefixIsSet
ПрефиксИнформационнойБазыПриемника=DestinationInfobasePrefix
ПрефиксИнформационнойБазыПриемникаУстановлен=DestinationInfobasePrefixSpecified
ПрефиксКорреспондента=CorrespondentPrefix
ПрефиксПоследнегоАвтономногоРабочегоМеста=LastStandaloneWorkstationPrefix
ПрефиксУзлаРаспределеннойИнформационнойБазы=DistributedInfobaseNodePrefix
ПриемникИндексКартинки=DestinationPictureIndex
ПриемникПоле1=DestinationField1
ПриемникПоле2=DestinationField2
ПриемникПоле3=DestinationField3
ПриемникПоле4=DestinationField4
ПриемникПоле5=DestinationField5
ПриложитьФайл=AttachFile
Применен=Applied
ПрименениеПравил=RulesApplication
ПрименитьПравилаОбработкиПисем=ApplyEmailProcessingRules
ПримечаниеЖурналаРегистрации=EventLogNote
ПринятаКИсполнению=AcceptedForExecution
ПринятыеДанныеПоКоллизии=ConflictDataAccepted
Приоритет=Priority
ПриоритетЗавершения=CompletionPriority
ПриоритетныеДанныеОбмена=PriorityExchangeData
ПриоритетОбновленияВОбластяхДанных=DataAreasUpdatePriority
ПриоритетОбъектаОбменаВыше=ExchangeObjectHigherPriority
ПриоритетОбъектаОбменаНиже=ExchangeObjectLowerPriority
ПриоритетОбъектаОбменаСовпадает=ExchangeObjectPriorityMatch
ПриоритетыВыполнения=ExecutionPriorities
ПриоритетыОбъектовОбмена=ExchangeObjectsPriorities
Приостановлен=Paused
ПриОтправкеДанныхГлавному=OnSendDataToMaster
ПриОтправкеДанныхПодчиненному=OnSendDataToSlave
ПриОтправкеПисемТребуетсяАвторизация=AuthorizationRequiredOnSendEmails
ПриПолученииДанныхОтГлавного=OnReceiveDataFromMaster
ПриПолученииДанныхОтПодчиненного=OnReceiveDataFromSlave
ПрисоединенныеФайлы=AttachedFiles
ПрисоединенныйФайл=AttachedFile
ПрисоединенныйФайлОбъект=AttachedFileObject
Причина=Cause
ПричинаОтключения=DisableReason
ПричинаОтменыСтарта=StartCancelReason
Причины=Reasons
ПричиныОтключенияДополнительныхОтчетовИОбработокВМоделиСервиса=ReasonsForDisablingAdditionalReportsAndDataProcessorsSaaS
ПроблемныйОбъект=ObjectWithIssue
ПроблемыПроизводительности=PerformanceIssues
ПровайдерSMS=SMSProvider
ПровайдерыSMS=SMSProviders
Проверен=Verified
ПроверитьВозможностьИзмененияНастроекОбменаДанными=CheckDataExchangeSettingsEditability
ПроверитьДоступПередЗаписью=CheckAccessBeforeWrite
ПроверитьДоступПередЗаписьюДокумента=CheckAccessBeforeWriteDocument
ПроверитьДоступПередЗаписьюНабораЗаписей=CheckAccessBeforeWriteRecordsSet
ПроверитьДоступПередЗаписьюНабораЗаписейРегистраРасчета=CheckAccessBeforeWriteCalculationRegisterRecordsSet
ПроверитьДоступПередУдалением=CheckAccessBeforeDelete
ПроверитьДоступПередУдалениемДокумента=CheckAccessBeforeDeleteDocument
ПроверитьДоступПриЗаписи=CheckAccessOnWrite
ПроверитьДоступПриЗаписиДокумента=CheckAccessOnWriteDocument
ПроверитьДоступПриЗаписиНабораЗаписей=CheckAccessOnWriteRecordsSet
ПроверитьДоступПриЗаписиНабораЗаписейРегистраРасчета=CheckAccessOnWriteCalculationRegisterRecordsSet
ПроверитьИзменениеФильтровОграниченияМиграцииДанных=CheckDataMigrationRestrictionFiltersChanged
ПроверитьИзмененияДатВПредмете=CheckForChangesOfDatesInSubject
ПроверитьПодключение=TestConnection
ПроверитьУстранениеПроблемыДокумента=CheckDocumentIssueResolved
ПроверитьУстранениеПроблемыОбъекта=CheckObjectIssueResolved
ПроверитьФормулу=CheckFormula
Проверка=Validation
ПроверкаВеденияУчета=AccountingCheck
ПроверкаВеденияУчетаИзменена=AccountingCheckIsChanged
ПроверкаДополнительныхОтчетовИОбработок=AdditionalReportsAndDataProcessorsCheck
ПроверкаДоступаКУчетнойЗаписи=CheckAccountAccess
ПроверкаЛегальностиПолученияОбновления=SoftwareLicenseCheck
ПроверкаЛегальностиПолученияОбновленияКлиент=SoftwareLicenseCheckClient
ПроверкаНастроекУчетнойЗаписи=ValidatingAccountSettings
ПроверкаПечатныхФорм=CheckPrintForms
ПроверкаПодключения=ConnectionCheckUp
ПроверкаСертификата=CertificateCheck
ПроверкаСертификатаНеВыполнялась=NoCertificateCheckPerformed
ПроверкаСертификатаОшибка=CertificateCheckError
ПроверкаСертификатаПредупреждение=CertificateCheckWarning
ПроверкаСертификатаУспех=CertificateCheckSuccess
ПроверкаСинхронизацииДанных=DataSynchronizationCheck
ПроверкаЦелостностиТома=VolumeIntegrityCheck
ПроверятьИспользованиеУдаляемыхОбъектов=CheckIfObjectsToDeleteAreUsed
ПроверятьКорректность=CheckValidity
ПроверятьЭлектронныеПодписиНаСервере=VerifyDigitalSignaturesOnTheServer
Проверяющий=Supervisor
ПроводитьРезервноеКопированиеПриВосстановленииДанных=BackUpOnRestoreData
Программа=Application
ПрограммаВОблачномСервисе=ApplicationInCloudService
ПрограммаЭлектроннойПодписи=DigitalSignatureApplication
ПрограммыЭлектроннойПодписиИШифрования=DigitalSignatureAndEncryptionApplications
ПрогрессОбновленияОбластейДанных=DataAreasUpdateProgress
ПрогрессОтложенногоОбновления=DeferredUpdateProgress
ПродолжительностьРаботыРегламентныхЗаданий=ScheduledJobsDuration
ПродолжитьПриОшибке=ContinueOnError
Производительность=Performance
ПроизводственныеКалендари=BusinessCalendars
ПроизводственныйКалендарь=BusinessCalendar
Произвольное=CustomValue
ПроизвольныйПараметр=ArbitraryParameter
ПропускатьОбъектыСОшибкамиПроверкиПоСхеме=SkipObjectsWithSchemaCheckErrors
ПропуститьПроверкуЗапретаИзменения=SkipPeriodClosingCheck
Пропущена=IsSkipped
Просмотр=View
ПросмотрДанных=DataView
ПросмотрЖурналаРегистрации=ViewEventLog
ПросмотрОписанияИзмененийПрограммы=ViewApplicationChangeLog
ПросмотрОтчетаДвиженияДокумента=ViewDocumentRecordsReport
ПросмотрСвязанныеДокументы=ViewRelatedDocuments
ПросроченныеДанныеЦвет=OverdueDataColor
ПросроченныеЗадачи=OverdueTasks
ПросрочкаРаботыВПрограммеДоЗапрещенияВхода=InactivityPeriodBeforeDenyingAuthorization
ПростаяФормаЗаписиНастройки=SimpleRecordFormSettings
Простой=Basic
ПростойТекст=PlainText
ПростойШаблон=SimpleTemplate
ПростыеВопросы=SimpleQuestions
ПротоколВходящейПочты=ProtocolForIncomingMail
ПрофилиБезопасности=SecurityProfiles
ПрофилиГруппДоступа=AccessGroupProfiles
ПрофилиКлючевыхОпераций=KeyOperationProfiles
Профиль=Profile
ПрофильБезопасностиИнформационнойБазы=InfobaseSecurityProfile
Процедура=Procedure
Процедура1=Procedure1
Процедура2=Procedure2
ПроцедураЗаполненияДанныхОбновления=UpdateDataFillingProcedure
ПроцедураПисатель=WriteProcedure
ПроцедураПроверки=CheckProcedure
ПроцедураЧитательИлиПисатель2=ReadOrWriteProcedure2
ПроцентСопоставленияОбъектов=MappedObjectPercentage
ПроцессОтложен=ProcessPostponed
ПроцессыДляЗапуска=ProcessesToStart
ПрочиеПользовательскиеНастройки=OtherUserSettings
ПсевдонимыПредопределенныхУзлов=PredefinedNodesAliases
Публикация=Publication
ПубличныеИдентификаторыСинхронизируемыхОбъектов=SynchronizedObjectPublicIDs
Пустая=IsEmpty
ПустаяСсылкаЛюбогоТипа=EmptyRefAnyType
ПустаяСхемаКомпоновкиДанных=EmptyDataCompositionSchema
ПустойРабочийСтол=BlankHomePage
ПутиКПрограммамЭлектроннойПодписиИШифрованияНаСерверахLinux=PathsToDigitalSignatureAndEncryptionApplicationsOnLinuxServers
ПутиКПрограммеНаСерверахLinux=PathToApplicationOnLinuxServers
Путь=Path
ПутьКМенеджеруОбменаВыгрузки=PathToExportExchangeManager
ПутьКМенеджеруОбменаЗагрузки=PathToImportExchangeManager
ПутьКПрограмме=ApplicationPath
ПутьКТомуБезУчетаРегиональныхНастроек=VolumePathIgnoreRegionalSettings
ПутьКФайлу=PathToFile
ПФ_MXL_ПроизводственныйКалендарь=PF_MXL_BusinessCalendar
РаботаВАвтономномРежиме=StandaloneWorkplace
РаботаВБезопасномРежиме=SafeModeManager
РаботаВБезопасномРежимеКлиент=SafeModeManagerClient
РаботаВБезопасномРежимеКлиентПереопределяемый=SafeModeManagerClientOverridable
РаботаВБезопасномРежимеПереопределяемый=SafeModeManagerOverridable
РаботаВБезопасномРежимеСлужебный=SafeModeManagerInternal
РаботаВЛокальномРежиме=LocalMode
РаботаВМоделиСервиса=SaaSOperations
РаботаВМоделиСервисаБСП=SaaSOperationsSSL
РаботаСБанками=BankManager
РаботаСБанкамиГлобальный=BankManagerGlobal
РаботаСБанкамиКлиент=BankManagerClient
РаботаСБанкамиПереопределяемый=BankManagerOverridable
РаботаСБанкамиСлужебный=BankManagerInternal
РаботаСВнешнимиРесурсамиЗаблокирована=OperationsWithExternalResourcesLocked
РаботаСКурсамиВалют=CurrencyRateOperations
РаботаСКурсамиВалютВызовСервера=CurrenciesExchangeRatesServerCall
РаботаСКурсамиВалютГлобальный=CurrencyRateOperationsGlobal
РаботаСКурсамиВалютКлиент=CurrencyRateOperationsClient
РаботаСКурсамиВалютКлиентСервер=CurrencyRateOperationsClientServer
РаботаСКурсамиВалютПереопределяемый=CurrencyRateOperationsOverridable
РаботаСКурсамиВалютСлужебный=CurrencyRateOperationsInternal
РаботаСПочтовымиСообщениями=EmailOperations
РаботаСПочтовымиСообщениямиВызовСервера=EmailServerCall
РаботаСПочтовымиСообщениямиКлиент=EmailOperationsClient
РаботаСПочтовымиСообщениямиКлиентПереопределяемый=EmailOperationsClientOverridable
РаботаСПочтовымиСообщениямиПереопределяемый=EmailOperationsOverridable
РаботаСПочтовымиСообщениямиСлужебный=EmailOperationsInternal
РаботаСФайлами=FilesOperations
РаботаСФайламиВМоделиСервиса=FilesOperationsSaaS
РаботаСФайламиВТомахСлужебный=FilesOperationsInVolumesInternal
РаботаСФайламиКлиент=FilesOperationsClient
РаботаСФайламиКлиентПереопределяемый=FilesOperationsClientOverridable
РаботаСФайламиКлиентСервер=FilesOperationsClientServer
РаботаСФайламиПереопределяемый=FilesOperationsOverridable
РаботаСФайламиСлужебный=FilesOperationsInternal
РаботаСФайламиСлужебныйВМоделиСервиса=FilesOperationsInternalSaaS
РаботаСФайламиСлужебныйВМоделиСервисаПовтИсп=FilesOperationsInternalSaaSCached
РаботаСФайламиСлужебныйВызовСервера=FilesOperationsInternalServerCall
РаботаСФайламиСлужебныйКлиент=FilesOperationsInternalClient
РаботаСФайламиСлужебныйКлиентПовтИсп=FilesOperationsInternalClientCached
РаботаСФайламиСлужебныйКлиентСервер=FilesOperationsInternalClientServer
РаботаСФайламиСлужебныйПовтИсп=FilesOperationsInternalCached
РабочиеКаталогиФайлов=FileWorkingDirectories
Рабочий=Work
РабочийКаталогПоУмолчанию=DefaultWorkingDirectory
РазблокированиеРеквизитов=AttributeUnlocking
Раздел=Section
РазделАдминистрирование=AdministrationSection
РазделАдминистрирование48=AdministrationSection48
РазделВариантовОтчетовШрифт=ReportsOptionsSectionFont
РазделениеДанныхСеанса=SessionDataSeparation
Разделы=Sections
РазделыДатЗапретаИзменения=PeriodClosingDatesSections
Размер=Size
РазмерДанных=DataSize
РазмерЗадания=JobSize
РазмерыБумаги=PaperSizes
РазместитьВРазделах=PlaceInSections
РазместитьФайлыНачальногоОбраза=StoreInitialImageFiles
РазмеченныйТекст=RichText
Размещение=Location
РазмещениеВРазделах=PlacementInSections
РазорватьСоединение=Disconnect
Разрешения=Permissions
РазрешенияНаИспользованиеВнешнихРесурсов=PermissionsToUseExternalResources
РазрешенияНеоднозначностей=ResolveConflicts
РазрешенияСканированногоИзображения=ScannedImageResolutions
РазрешенныйНаборГруппДоступа=AllowedAccessGroupsSet
РазрешенныйНаборГруппПользователей=AllowedUserGroupsSet
РазрешенныйПользователь=AllowedUser
РазрешенныйПустойНаборГруппДоступа=AllowedBlankAccessGroupsSet
РазрешитьВводНесколькихЗначений=AllowMultipleValueInput
РазрешитьВыполнениеДООРегламентнымиЗаданиямиВМоделиСервиса=AllowScheduledJobsExecutionSaaS
РазрешитьРедактированиеРеквизитовОбъекта=AllowObjectAttributeEdit
Расписание=Schedule
РасписаниеВыполненияПроверки=CheckRunSchedule
РасписаниеРаботы=WorkSchedule
Рассмотрено=Reviewed
РассмотретьПосле=ReviewAfter
Рассчитать=Calculate
Рассылка=BulkEmail
РассылкаОтчетов=ReportMailing
РассылкаОтчетовВызовСервера=ReportMailingServerCall
РассылкаОтчетовКлиент=ReportMailingClient
РассылкаОтчетовКлиентПереопределяемый=ReportMailingClientOverridable
РассылкаОтчетовКлиентСервер=ReportMailingClientServer
РассылкаОтчетовПереопределяемый=ReportMailingOverridable
РассылкаОтчетовПовтИсп=ReportMailingCached
РассылкиОтчетов=ReportMailings
РасчетПоФормуле=CalculationByFormula
Расширение=Extension
РасширениеКонфигурацииИзГлавногоУзла=ConfigurationExtensionFromMasterNode
РасширениеФайла=FileExtention
РасширениеФормата=FormatExtension
Расширения=Extensions
РасширеннаяНастройкаФильтраОтчета=AdvancedReportFilterSetting
РасширенноеПредставлениеОшибки=ExtendedErrorPresentation
Расшифровка=Details
РасшифровкаДанных=DataDecryption
РасшифровкаПростыхОтветов=BasicQuestionAnswersDetails
РасшифровкаРегламентныхЗаданий=ScheduledJobsDetails
РасшифровкаТабличныхВопросов=TableQuestionsDetails
РегиональныеНастройки=RegionalSettings
Регистр=Register
РегистрацияИзмененийДляОбменаДанными=RegisterChangesForDataExchange
РегистрацияИзмененийДляОтправки=RegisterChangesToSend
РегистрСведенийАдресныеОбъекты=InformationRegisterAddressObjects
РегистрСведенийБезопасноеХранилищеДанных=InformationRegisterSafeDataStorage
РегистрСведенийБезопасноеХранилищеДанныхОбластейДанных=InformationRegisterSafeDataAreaDataStorage
РегистрСведенийБлокировкиСеансовОбластейДанных=InformationRegisterDataAreaSessionLocks
РегистрСведенийБуферОперацийСтатистики=InformationRegisterStatisticsOperationsClipboard
РегистрСведенийВерсииКлассификаторов=InformationRegisterClassifiersVersions
РегистрСведенийВерсииКлассификаторовОбластейДанных=InformationRegisterDataAreasClassifiersVersions
РегистрСведенийВерсииОбъектов=InformationRegisterObjectsVersions
РегистрСведенийВерсииПодсистем=InformationRegisterSubsystemsVersions
РегистрСведенийВерсииПодсистемОбластейДанных=InformationRegisterDataAreasSubsystemsVersions
РегистрСведенийВременныеИдентификаторыЗапросов=InformationRegisterTemporaryQueriesIDs
РегистрСведенийГруппыЗначенийДоступа=InformationRegisterAccessValuesGroups
РегистрСведенийДампыПлатформы=InformationRegisterPlatformDumps
РегистрСведенийДанныеБизнесПроцессов=InformationRegisterBusinessProcessesData
РегистрСведенийДанныеОбработанныеВЦентральномУзлеРИБ=InformationRegisterDataProcessedInMasterDIBNode
РегистрСведенийДанныеОбъектовДляРегистрацииВОбменах=InformationRegisterObjectsDataToRegisterInExchanges
РегистрСведенийДанныеПроизводственногоКалендаря=InformationRegisterBusinessCalendarData
РегистрСведенийДатыЗапретаИзменения=InformationRegisterPeriodClosingDates
РегистрСведенийДатыПоследнейЗагрузкиПочтовыхСообщений=InformationRegisterLastEmailImportDate
РегистрСведенийДвоичныеДанныеФайлов=InformationRegisterBinaryFilesData
РегистрСведенийДомаЗданияСтроения=InformationRegisterHousesBuildingsUnits
РегистрСведенийДополнительныеАдресныеСведения=InformationRegisterAdditionalAddressInfo
РегистрСведенийДополнительныеСведения=InformationRegisterAdditionalInfo
РегистрСведенийДоступныеЛицензии=InformationRegisterAvailableLicenses
РегистрСведенийЗаблокированныеДляПолученияУчетныеЗаписи=InformationRegisterAccountsLockedForReceipt
РегистрСведенийЗависимостиПравДоступа=InformationRegisterAccessRightsDependencies
РегистрСведенийЗагруженныеВерсииАдресныхСведений=InformationRegisterImportedAddressInfoVersions
РегистрСведенийЗамерыВремени=InformationRegisterTimeMeasurements
РегистрСведенийЗамерыВремениТехнологические=InformationRegisterTimeMeasurementsTechnological
РегистрСведенийЗамерыКомментарииСтатистики=InformationRegisterMeasurementsStatisticsComments
РегистрСведенийЗамерыОбластиСтатистики=InformationRegisterMeasurementsStatisticsAreas
РегистрСведенийЗамерыОперацииСтатистики=InformationRegisterMeasurementsStatisticsOperations
РегистрСведенийЗамерыСтатистики=InformationRegisterStatisticsMeasurements
РегистрСведенийЗанятыеЛицензии=InformationRegisterLockedLicenses
РегистрСведенийЗапросыРазрешенийНаИспользованиеВнешнихРесурсов=InformationRegisterRequestsForPermissionsToUseExternalResources
РегистрСведенийЗапросыРазрешенийНаИспользованиеВнешнихРесурсовВМоделиСервиса=InformationRegisterRequestPermissionsToAccessExternalResourcesSaaS
РегистрСведенийЗапросыРазрешенийНаИспользованиеВнешнихРесурсовОбластейДанных=InformationRegisterRequestPermissionsToAccessExternalResourcesForDataAreas
РегистрСведенийЗапущенныеОбработчикиОчередиЗаданий=InformationRegisterRunningJobsQueueHandlers
РегистрСведенийЗемельныеУчастки=InformationRegisterLandLots
РегистрСведенийЗначенияГруппДоступа=InformationRegisterAccessGroupsValues
РегистрСведенийЗначенияГруппДоступаПоУмолчанию=InformationRegisterDefaultAccessGroupsValues
РегистрСведенийИдентификаторыЗапросовНаПодключение=InformationRegisterConnectionRequestID
РегистрСведенийИдентификаторыОбъектовВерсийРасширений=InformationRegisterExtensionVersionObjectIDs
РегистрСведенийИдентификаторыПолученныхЭлектронныхПисем=InformationRegisterReceivedEmailIDs
РегистрСведенийИзмененияОбщихДанныхУзлов=InformationRegisterCommonNodeDataChanges
РегистрСведенийИнцидентыОткрытые=InformationRegisterOpenedIncidents
РегистрСведенийИнцидентыОтложенныеПроверки=InformationRegisterIncidentsDeferredChecks
РегистрСведенийИсполнителиЗадач=InformationRegisterTaskPerformers
РегистрСведенийИспользованиеДополнительныхОтчетовИОбработокСервисаВАвтономномРабочемМесте=InformationRegisterUseAdditionalReportsAndServiceProcessorsAtStandaloneWorkstation
РегистрСведенийИспользованиеПоставляемыхДополнительныхОтчетовИОбработокВОбластяхДанных=InformationRegisterUseSuppliedAdditionalReportsAndProcessorsInDataAreas
РегистрСведенийИспользованиеПоставляемыхРасширенийВОбластяхДанных=InformationRegisterUseSuppliedExtensionsInDataAreas
РегистрСведенийИспользуемыеВидыДоступа=InformationRegisterUsedAccessKinds
РегистрСведенийИспользуемыеВидыДоступаПоТаблицам=InformationRegisterUsedAccessKindsByTables
РегистрСведенийИсторияАдресныхОбъектов=InformationRegisterAddressObjectHistory
РегистрСведенийКалендарныеГрафики=InformationRegisterCalendarSchedules
РегистрСведенийКлючиДоступаВнешнихПользователей=InformationRegisterExternalUsersAccessKeys
РегистрСведенийКлючиДоступаГруппДоступа=InformationRegisterAccessGroupsAccessKeys
РегистрСведенийКлючиДоступаКОбъектам=InformationRegisterAccessKeysForObjects
РегистрСведенийКлючиДоступаКРегистрам=InformationRegisterAccessKeysForRegisters
РегистрСведенийКлючиДоступаКРегиструРезультатыПроверкиУчета=InformationRegisterAccessKeysToRegisterAccountingCheckResults
РегистрСведенийКлючиДоступаНаборовГруппДоступа=InformationRegisterAccessGroupSetsAccessKeys
РегистрСведенийКлючиДоступаПользователей=InformationRegisterUsersAccessKeys
РегистрСведенийКодировкиФайлов=InformationRegisterFIleEncodings
РегистрСведенийКомментарииОперацииСтатистики=InformationRegisterStatisticsOperationComments
РегистрСведенийКомментарииСтатистики=InformationRegisterStatisticsComments
РегистрСведенийКонтактыВзаимодействий=InformationRegisterInteractionsContacts
РегистрСведенийКурсыВалют=InformationRegisterExchangeRates
РегистрСведенийКэшДанныхКлассификаторов=InformationRegisterClassifiersDataCache
РегистрСведенийКэшПереводов=InformationRegisterTranslationCache
РегистрСведенийКэшПрограммныхИнтерфейсов=InformationRegisterProgramInterfaceCache
РегистрСведенийКэшТестовыхПериодов=InformationRegisterTrialPeriodsCache
РегистрСведенийМиграцияПриложенийОчередьЗагрузки=InformationRegisterApplicationsMigrationImportQueue
РегистрСведенийМиграцияПриложенийСостояниеВыгрузки=InformationRegisterApplicationsMigrationExportState
РегистрСведенийМиграцияПриложенийСостояниеЗагрузки=InformationRegisterApplicationsMigrationImportState
РегистрСведенийНаборыЗначенийДоступа=InformationRegisterAccessValueSets
РегистрСведенийНазначениеДополнительныхОбработок=InformationRegisterAdditionalDataProcessorsPurposes
РегистрСведенийНаличиеФайлов=InformationRegisterHasAttachments
РегистрСведенийНапоминанияПользователя=InformationRegisterUserReminders
РегистрСведенийНаследованиеНастроекПравОбъектов=InformationRegisterObjectRightsSettingsInheritance
РегистрСведенийНастройкиВариантовОтчетов=InformationRegisterReportOptionsSettings
РегистрСведенийНастройкиВерсионированияОбъектов=InformationRegisterObjectVersioningSettings
РегистрСведенийНастройкиКомандПечати=InformationRegisterPrintCommandsSettings
РегистрСведенийНастройкиОбменаДаннымиXDTO=InformationRegisterXDTODataExchangeSettings
РегистрСведенийНастройкиОтправителя=InformationRegisterSenderSettings
РегистрСведенийНастройкиОчисткиФайлов=InformationRegisterFilesClearingSettings
РегистрСведенийНастройкиПравОбъектов=InformationRegisterObjectsRightsSettings
РегистрСведенийНастройкиСинхронизацииФайлов=InformationRegisterFileSynchronizationSettings
РегистрСведенийНастройкиТранспортаОбменаДанными=InformationRegisterDataExchangeTransportSettings
РегистрСведенийНастройкиТранспортаОбменаОбластейДанных=InformationRegisterDataAreasExchangeTransportSettings
РегистрСведенийНастройкиТранспортаОбменаОбластиДанных=InformationRegisterDataAreaExchangeTransportSettings
РегистрСведенийНастройкиТранспортаОбменаСообщениями=InformationRegisterMessageExchangeTransportSettings
РегистрСведенийНастройкиУчетныхЗаписейЭлектроннойПочты=InformationRegisterEmailAccountSettings
РегистрСведенийНастройкиУчетныхСистем=InformationRegisterAccountingSystemsSettings
РегистрСведенийНепринятыеКОбработкеПочтовымСерверомИсходящиеПисьма=InformationRegisterOutgoingMailNotAcceptedByMailServer
РегистрСведенийНеразделенныеПользователи=InformationRegisterSharedUsers
РегистрСведенийНеудаленныеОбъекты=InformationRegisterNotDeletedObjects
РегистрСведенийНомераОтсканированныхФайлов=InformationRegisterScannedFilesNumbers
РегистрСведенийОбластиДанных=InformationRegisterDataAreas
РегистрСведенийОбластиПерсональныхДанных=InformationRegisterPersonalDataAreas
РегистрСведенийОбластиСтатистики=InformationRegisterStatisticsAreas
РегистрСведенийОбновлениеКлючейДоступаКДанным=InformationRegisterDataAccessKeysUpdate
РегистрСведенийОбновлениеКлючейДоступаПользователей=InformationRegisterUsersAccessKeysUpdate
РегистрСведенийОбновлениеКлючейДоступаТекущиеЗадания=InformationRegisterAccessKeysUpdateCurrentJobs
РегистрСведенийОбработчикиОбновления=InformationRegisterUpdateHandlers
РегистрСведенийОбработчикиОбновленияОбщихДанных=InformationRegisterSharedDataUpdateHandlers
РегистрСведенийОбработчикиСобытийСинхронизацииДанных=InformationRegisterDataSyncEventHandlers
РегистрСведенийОбщиеНастройкиУзловИнформационныхБаз=InformationRegisterCommonInfobasesNodesSettings
РегистрСведенийОбщиеПоставляемыеМакетыПечати=InformationRegisterCommonSuppliedPrintTemplates
РегистрСведенийОбъектыКОтправке=InformationRegisterObjectsToSend
РегистрСведенийОграничениеСкоростиОтсылкиИнцидентов=InformationRegisterIncidentsSendingSpeedLimit
РегистрСведенийОперацииСтатистики=InformationRegisterStatisticsOperations
РегистрСведенийОриентирыАдресныхОбъектов=InformationRegisterAddressObjectLandmarks
РегистрСведенийОтветыНаВопросыАнкет=InformationRegisterQuestionnaireQuestionAnswers
РегистрСведенийОчередьИзвлеченияТекста=InformationRegisterTextExtractionQueue
РегистрСведенийОчередьИнсталляцииПоставляемыхДополнительныхОтчетовИОбработокВОбластиДанных=InformationRegisterSuppliedAdditionalReportAndDataProcessorInstallationQueueInDataArea
РегистрСведенийОчередьИнсталляцииПоставляемыхРасширенийВОбластиДанных=InformationRegisterSuppliedExtensionInstallationQueueInDataArea
РегистрСведенийОчередьОбновляемыхПоставляемыхРасширенийВОбластяхДанных=InformationRegisterSuppliedExtensionsToUpdateQueueInDataAreas
РегистрСведенийОчередьРасширенийДляОповещений=InformationRegisterExtensionsForNotificationsQueue
РегистрСведенийПакетыДляОтправки=InformationRegisterPackagesToSend
РегистрСведенийПакетыИнформацииПриЗапуске=InformationRegisterInformationPackagesOnStart
РегистрСведенийПараметрыОграниченияДоступа=InformationRegisterAccessRestrictionParameters
РегистрСведенийПараметрыРаботыВерсийРасширений=InformationRegisterExtensionVersionParameters
РегистрСведенийПараметрыРаботыПрограммы=InformationRegisterApplicationParameters
РегистрСведенийПериодыНерабочихДнейКалендаря=InformationRegisterCalendarNonWorkDaysPeriods
РегистрСведенийПодпискиПолучателей=InformationRegisterRecipientSubscriptions
РегистрСведенийПользовательскиеМакетыПечати=InformationRegisterUserPrintTemplates
РегистрСведенийПользовательскиеНастройкиДоступаКОбработкам=InformationRegisterDataProcessorAccessUserSettings
РегистрСведенийПоставляемыеДанныеТребующиеОбработки=InformationRegisterSuppliedDataRequiringProcessing
РегистрСведенийПоставляемыеДанныеТребующиеОбработкиВОбластях=InformationRegisterSuppliedDataRequiringProcessingInAreas
РегистрСведенийПоставляемыеМакетыПечати=InformationRegisterSuppliedPrintTemplates
РегистрСведенийПотокиОбновления=InformationRegisterUpdateThreads
РегистрСведенийПраваРолей=InformationRegisterRolesRights
РегистрСведенийПравилаДляОбменаДанными=InformationRegisterDataExchangeRules
РегистрСведенийПредметыПапкиВзаимодействий=InformationRegisterInteractionsFolderSubjects
РегистрСведенийПредопределенныеВариантыОтчетовВерсийРасширений=InformationRegisterPredefinedExtensionsVersionsReportsOptions
РегистрСведенийПрименениеРазрешенийНаИспользованиеВнешнихРесурсовВМоделиСервиса=InformationRegisterApplyPermissionsToUseExternalResourcesSaaS
РегистрСведенийПрименениеРазрешенийНаИспользованиеВнешнихРесурсовОбластейДанных=InformationRegisterApplyPermissionsToUseExternalResourcesForDataAreas
РегистрСведенийПричиныИзмененияАдресныхСведений=InformationRegisterAddressInfoChangeReasons
РегистрСведенийПросмотренныеДанныеИнформационногоЦентра=InformationRegisterInfoCenterViewedData
РегистрСведенийПроцессыДляЗапуска=InformationRegisterProcessesToStart
РегистрСведенийПсевдонимыПредопределенныхУзлов=InformationRegisterPredefinedNodesAliases
РегистрСведенийПубличныеИдентификаторыСинхронизируемыхОбъектов=InformationRegisterSynchronizedObjectPublicIDs
РегистрСведенийПутиКПрограммамЭлектроннойПодписиИШифрованияНаСерверахLinux=InformationRegisterPathsToDigitalSignatureAndEncryptionApplicationsOnLinuxServers
РегистрСведенийРабочиеКаталогиФайлов=InformationRegisterFileWorkingDirectories
РегистрСведенийРазрешенияНаИспользованиеВнешнихРесурсов=InformationRegisterPermissionsToUseExternalResources
РегистрСведенийРазрешенияНаИспользованиеВнешнихРесурсовВМоделиСервиса=InformationRegisterPermissionsToUseExternalResourcesSaaS
РегистрСведенийРазрешенияНаИспользованиеВнешнихРесурсовОбластейДанных=InformationRegisterPermissionsToUseExternalResourcesForDataAreas
РегистрСведенийРежимыПодключенияВнешнихМодулей=InformationRegisterExternalModulesAttachmentModes
РегистрСведенийРежимыПодключенияВнешнихМодулейВМоделиСервиса=InformationRegisterExternalModulesConnectionOptionsSaaS
РегистрСведенийРежимыПодключенияВнешнихМодулейОбластейДанных=InformationRegisterDataAreaExternalModulesAttachmentModes
РегистрСведенийРезультатыОбменаДанными=InformationRegisterDataExchangeResults
РегистрСведенийРезультатыПроверкиУчета=InformationRegisterAccountingCheckResults
РегистрСведенийРейтингАктивностиОбластейДанных=InformationRegisterDataAreaActivityRating
РегистрСведенийРучныеИзмененияГрафиковРаботы=InformationRegisterManualWorkScheduleChanges
РегистрСведенийСведенияОПользователях=InformationRegisterUsersInfo
РегистрСведенийСведенияОФайлах=InformationRegisterFilesInfo
РегистрСведенийСвойстваЗаданий=InformationRegisterJobsProperties
РегистрСведенийСвязиАдресныхОбъектов=InformationRegisterAddressObjectsReferences
РегистрСведенийСертификатыПользователяDSS=InformationRegisterDSSUserCertificates
РегистрСведенийСертификатыШифрования=InformationRegisterEncryptionCertificates
РегистрСведенийСессииОбменаСообщениямиСистемы=InformationRegisterSystemMessageExchangeSessions
РегистрСведенийСклоненияПредставленийОбъектов=InformationRegisterObjectPresentationDeclensions
РегистрСведенийСлужебныеАдресныеСведения=InformationRegisterInternalAddressInfo
РегистрСведенийСогласияНаОбработкуПерсональныхДанных=InformationRegisterPersonalDataProcessingConsents
РегистрСведенийСообщенияОбменаДанными=InformationRegisterDataExchangeMessages
РегистрСведенийСообщенияОбменаДаннымиОбластейДанных=InformationRegisterDataAreaDataExchangeMessages
РегистрСведенийСоответствияОбъектовИнформационныхБаз=InformationRegisterInfobaseObjectsMaps
РегистрСведенийСоставыГруппПользователей=InformationRegisterUserGroupCompositions
РегистрСведенийСостоянияИнтеграцииОбъектов=InformationRegisterObjectsIntegrationStates
РегистрСведенийСостоянияКонтактовВзаимодействий=InformationRegisterInteractionsContactStates
РегистрСведенийСостоянияОбменовДанными=InformationRegisterDataExchangesStates
РегистрСведенийСостоянияОбменовДаннымиОбластейДанных=InformationRegisterDataAreaDataExchangeStates
РегистрСведенийСостоянияОригиналовПервичныхДокументов=InformationRegisterSourceDocumentsOriginalsStates
РегистрСведенийСостоянияПапокПисем=InformationRegisterEmailFolderStates
РегистрСведенийСостоянияПредметовВзаимодействий=InformationRegisterInteractionsSubjectsStates
РегистрСведенийСостоянияПроверокВеденияУчета=InformationRegisterAccountingChecksStates
РегистрСведенийСостоянияРассылокОтчетов=InformationRegisterReportMailingStates
РегистрСведенийСостоянияУспешныхОбменовДанными=InformationRegisterSuccessfulDataExchangesStates
РегистрСведенийСостоянияУспешныхОбменовДаннымиОбластейДанных=InformationRegisterDataAreasSuccessfulDataExchangeStates
РегистрСведенийСтатистикаКонфигурации=InformationRegisterConfigurationStatistics
РегистрСведенийСтатусыСинхронизацииФайловСОблачнымСервисом=InformationRegisterFilesSynchronizationWithCloudServiceStatuses
РегистрСведенийСубъектыДляСкрытияПерсональныхДанных=InformationRegisterSubjectsToHidePersonalData
РегистрСведенийТаблицыГруппДоступа=InformationRegisterAccessGroupsTables
РегистрСведенийУведомленияОПрочтении=InformationRegisterReadReceipts
РегистрСведенийУдаляемыеОбъекты=InformationRegisterObjectsToDelete
РегистрСведенийУровниСокращенийАдресныхСведений=InformationRegisterLevelsOfAddressInfoShortForms
РегистрСведенийФайлыВРабочемКаталоге=InformationRegisterFilesInWorkingDirectory
РегистрСведенийФайлыОбластейДанных=InformationRegisterDataAreaFiles
РегистрСведенийХранилищеСертификатов=InformationRegisterCertificatesStorage
РегистрСведенийЭлектронныеПодписи=InformationRegisterDigitalSignatures
РегламентноеЗадание=ScheduledJob
РегламентноеЗаданиеGUID=GUIDScheduledJob
РегламентныеЗадания=ScheduledJobs
РегламентныеЗаданияКлиент=ScheduledJobsClient
РегламентныеЗаданияПереопределяемый=ScheduledJobsOverridable
РегламентныеЗаданияСервер=ScheduledJobsServer
РегламентныеЗаданияСлужебный=ScheduledJobsInternal
РегламентныеИФоновыеЗадания=ScheduledAndBackgroundJobs
Редактирование=Edit
РедактированиеБланка=EditTemplate1
РедактированиеГиперссылки=EditHyperlink
РедактированиеДатыЗапрета=PeriodEndClosingDateEdit
РедактированиеДополнительныхСведений=AdditionalDataEditing
РедактированиеМакета=EditTemplate2
РедактированиеПериодаИОтбора=PeriodAndFilterEdit
РедактированиеПечатныхФорм=PrintFormsEdit
РедактированиеРеквизитовОбъектов=EditObjectAttributes
РедактированиеСоставаНастроек=SettingsCompositionEdit
РедактированиеТабличногоДокумента=EditSpreadsheetDocument
РедактированиеТекстовогоФайла=EditTextFile
РедактированиеФормулы=FormulaEdit
РедактированиеШаблонаЗавершено=TemplateEditCompleted
РедактироватьАдресСайта=EditWebsiteAddress
РедактироватьМакет=EditTemplate
РедактироватьФайл=EditFile
РедактируемыеФайлы=FilesToEdit
РедактируемыйРаздел=SectionToEdit
Редактирует=BeingEditedBy
РедакторСоставаСвойства=PropertyCompositionEditor
РедакцияЧислом=RevisionAsNumber
РежимАнкетирования=SurveyMode
РежимВыполнения=ExecutionMode
РежимВыполненияОтложенногоОбработчика=DeferredHandlerExecutionMode
РежимВыполненияОтложенныхОбработчиков=DeferredHandlersExecutionMode
РежимЗагрузкиДанных=DataImportMode
РежимЗагрузкиСообщенияОбменаДаннымиПередЗапуском=DataExchangeMessageImportModeBeforeStart
РежимЗамещения=ReplacementMode
РежимИспользованияПриложенияВСервисеЛокально=ApplicationUsageInServiceLocalMode
РежимОбмена=ExchangeMode
РежимОбновления=UpdateMode
РежимОтладки=DebugMode
РежимОтладкиАлгоритмов=AlgorithmsDebugMode
РежимОтладкиВыгрузки=ExportDebugMode
РежимОтладкиЗагрузки=ImportDebugMode
РежимОчисткиФайлов=FilesCleanupMode
РежимПротоколированияОбменаДанными=DataExchangeLoggingMode
РежимРазработчика=DeveloperMode
РежимСовместимостиРазрешений=PermissionsCompatibilityMode
РежимСозданияФайлаДляСохранитьКак=FileCreationModeForSaveAs
РежимТехническогоСпециалиста=TechnicianMode
РежимыАнкетирования=SurveyModes
РежимыВыгрузкиОбъектовОбмена=ExchangeObjectExportModes
РежимыВыполненияОбработчиков=HandlersExecutionModes
РежимыВыполненияОтложенныхОбработчиков=DeferredHandlersExecutionModes
РежимыОчисткиФайлов=FilesCleanupModes
РежимыПодключенияВнешнихМодулей=ExternalModulesAttachmentModes
РежимыСовместимостиРазрешенийДополнительныхОтчетовИОбработок=AdditionalReportsAndDataProcessorsPermissionCompatibilityModes
РезервноеКопированиеДанных=DataBackup
РезервноеКопированиеИБ=IBBackup
РезервноеКопированиеИБВызовСервера=IBBackupServerCall
РезервноеКопированиеИБГлобальный=IBBackupGlobal
РезервноеКопированиеИБКлиент=IBBackupClient
РезервноеКопированиеИБКлиентПереопределяемый=IBBackupClientOverridable
РезервноеКопированиеИБСервер=IBBackupServer
РезервноеКопированиеНастроено=BackupConfigured
Результат=Result
РезультатАвтоматическогоСопоставления=AutoMappingResult
РезультатВыгрузкиXDTO=XDTOExportResult
РезультатВыполнения=ExecutionResult
РезультатВыполненияОбмена=ExchangeExecutionResult
РезультатОбновления=UpdateResult
РезультатПроверки=CheckResult
РезультатСканирования=ScanningResult
РезультатУспехЦвет=SuccessResultColor
РезультатыВыполненияОбмена=ExchangeExecutionResults
РезультатыОбменаДанными=DataExchangeResults
РезультатыОбновленияПрограммы=ApplicationUpdateResult
РезультатыПроверкиУчета=AccountingCheckResults
Реквизит=Attribute
РеквизитДопУпорядочивания=AddlOrderingAttribute
Рекомендация=Recommendation
РекомендацияПоПовышениюСкоростиРаботы=SpeedupRecommendation
Респондент=Respondent
Респонденты=Respondents
Родитель=Parent
РодительВопрос=ParentQuestion
РодительскаяВерсия=ParentVersion
Роли=Roles
РолиИИсполнителиЗадач=RolesAndTaskPerformers
РолиИсполнителей=PerformerRoles
Роль=Role
РольБезИсполнителей=RoleWithoutPerformers
РольИсполнителя=PerformerRole
Русский=Russian
РучноеИзменение=ManualEdit
РучнойВвод=ManualInput
РучныеИзмененияГрафиковРаботы=ManualWorkScheduleChanges
СборИОтправкаОтчетовОбОшибках=ErrorReportCollectionAndSending
СборИОтправкаСтатистики=StatisticsDataCollectionAndSending
СброситьЗначениеРеквизитаУпорядочивания=ClearOrderAttributeValue
СброситьНастройкиПользователей=ResetUserSettings
СброситьНастройкиРазмещения=ResetAssignmentSettings
СбросНастроекРазмещения=ResetAssignmentToSections
СбросПользовательскихНастроек=UserSettingsReset
СведенияОБлокируемыхОбъектах=LockedObjectsInfo
СведенияОбОбновленииИБ=IBUpdateInfo
СведенияОПользователе=UserInfo
СведенияОПользователях=UsersInfo
СведенияОРегламентномЗадании=ScheduledJobInfo
СведенияОФайлах=FilesInfo
СВИФТБИК=SWIFTBIC
СвободныйОпрос=FreeSurvey
Свойства=Properties
СвойстваОбъекта=ObjectProperties
СвойстваПередУдалениемСсылочногоОбъекта=PropertiesBeforeDeleteReferenceObject
СвойстваПользователяИБ=IBUserProperies
Свойство=Property
Свойство1=Property1
Свойство2=Property2
Свойство3=Property3
Свойство4=Property4
Свойство5=Property5
СвязанныеДокументы=RelatedDocuments
СвязатьсяСоСпециалистомОнлайнПоддержки=ContactOnlineSupportSpecialist
СдвигГраницыИтогов=ShiftTotalsBoundary
СдвинутьВверх=ShiftUp
СдвинутьВниз=ShiftDown
СерверВходящейПочты=IncomingMailServer
СерверИсходящейПочты=OutgoingMailServer
Сервис=Service
СервисПереводаТекста=TextTranslationService
СервисыПереводаТекста=TextTranslationServices
Сертификат=Certificate
СертификатКлюча=KeyCertificate
СертификатыКлючейЭлектроннойПодписиИШифрования=DigitalSignatureAndEncryptionKeysCertificates
СертификатыШифрования=EncryptionCertificates
СессииОбменаСообщениямиСистемы=SystemMessageExchangeSessions
Сессия=Session
СетевойКаталогLinux=NetworkDirectoryLinux
СетевойКаталогWindows=NetworkDirectoryWindows
Синий=B
Синоним=Synonym
СинхронизацияДанных=DataSynchronization
СинхронизацияДанныхАнализДанных48=DataSynchronizationDataAnalysis48
СинхронизацияДанныхВыгрузить=DataSynchronizationExport
СинхронизацияДанныхВыполнение=DataSynchronizationExecution
СинхронизацияДанныхДанныеПолучены=DataSynchronizationDataReceived
СинхронизацияДанныхДлительнаяОперация=DataSyncTimeConsumingOperation
СинхронизацияДанныхДлительнаяОперация48=DataSyncTimeConsumingOperation48
СинхронизацияДанныхДляАдминистратораСервиса=DataSynchronizationForServiceAdministrator
СинхронизацияДанныхИнтерактивноеВыполнение=DataSynchronizationInteractiveExecute
СинхронизацияДанныхКоллизия=DataSynchronizationConflict
СинхронизацияДанныхНастройка=DataSynchronizationSettings
СинхронизацияДанныхНедоступна=DataSynchronizationUnavailable
СинхронизацияДанныхНепринятыеПоДате=DataSynchronizationDeclinedByDate
СинхронизацияДанныхОтключение=DataSynchronizationDisable
СинхронизацияДанныхПодсистема=DataSyncSubsystem
СинхронизацияДанныхСостояниеСинхронизации=DataSynchronizationSynchronizationState
СинхронизацияДанныхСПриложениемВИнтернете=DataSynchronizationWithWebApplication
СинхронизацияФайлов=FilesSynchronization
Синхронизирован=IsSynchronized
Синхронизировать=Synchronize
СинхронизироватьДанныеСПриложениемВИнтернетеПриЗавершенииРаботыПрограммы=SynchronizeDataWithInternetApplicationsOnExit
СинхронизироватьДанныеСПриложениемВИнтернетеПриНачалеРаботыПрограммы=SynchronizeDataWithInternetApplicationsOnStart
СинхронизироватьПоИдентификатору=SynchronizeByID
СинхронизироватьСДополнительнымиПараметрами=SynchronizeWithAdditionalParameters
СинхронизироватьФайлы=SynchronizeFiles
Синхронизируется=Synchronized
СистемнаяУчетнаяЗаписьЭлектроннойПочты=SystemEmailAccount
Сканирование=Scanning
Скачать=Download
СкопироватьВБуферОбмена=CopyToClipboard
СкопироватьРеквизитыВерсииФайловВФайл=CopyFileVersionAttributesToFile
Скрепка=Clip
СкриптСозданияЗадачиПланировщикаЗадач=TaskSchedulerTaskCreationScript
СкриптУдаленияПатчей=PatchesDeletionScript
СкрыватьНеактуальныеАдреса=HideObsoleteAddresses
СкрытаяНастройкаОтчета=HiddenReportSettingsItem
СкрытыеКопии=BCCs
СкрытыйВариантОтчетаЦвет=HiddenReportOptionColor
Скрыть=Hide
СлияниеИндексаППД=FullTextSearchMergeIndex
Служебный=IsInternal
СменаПароля=PasswordChange
СменаПочты=EmailAddressChange
СменитьПароль=ChangePassword
Смещение=Offset
СмТакже=SeeAlso
СнятьПризнакРассмотреноУВзаимодействия=RemoveInteractionReviewedAttribute
СобиратьСтатистикуКонфигурации=ShouldCollectStatistics
Событие=Event
СобытияОтправки=SendingEvents
СобытияПолучения=ReceivingEvents
СобытияРассылки=MailingEvents
Совместимость=Compatibility
СодержаниеПредмета=SubjectContent
СоединенияИБ=IBConnections
СоединенияИБВызовСервера=IBConnectionsServerCall
СоединенияИБГлобальный=IBConnectionsGlobal
СоединенияИБКлиент=IBConnectionsClient
СоединенияИБКлиентСервер=IBConnectionsClientServer
СоединенияИБПереопределяемый=IBConnectionsOverridable
СоздаватьПодкаталогиСИменамиВладельцев=CreateSubdirectoriesWithOwnersNames
СоздаватьРезервнуюКопию=CreateDataBackup
СоздаватьЭлектронныеПодписиНаСервере=GenerateDigitalSignaturesAtServer
Создание=Creating
СозданиеБотаВКонтакте=BotCreationVKontakte
СозданиеБотаТелеграм=BotCreationTelegram
СозданиеНаОсновании=GenerateFrom
СозданиеНаОснованииПереопределяемый=GenerateFromOverridable
СозданиеНаОснованииПовтИсп=GenerateFromCached
СозданиеНачальногоОбразаСФайлами=CreateInitialImageWithFiles
СозданиеСвязанныхОбъектов=RelatedObjectsCreation
СоздатьЗаметкуПоПредмету=CreateSubjectNote
СоздатьОбменДанными=CreateDataExchange
СоздатьПредопределенныеПапкиЭлектронныхПисем=CreatePredefinedEmailsFolders
СоздатьУзелОбменаДанными=CreateDataExchangeNode
Сообщение=Message
СообщениеSMS=SMSMessage
СообщениеSMSПрисоединенныеФайлы=SMSMessageAttachedFiles
СообщениеБлокировки=LockMessage
СообщениеДляПользователей=MessageForUsers
СообщениеДляСопоставленияДанных=MessageForDataMapping
СообщениеОбменаДаннымиИзГлавногоУзла=DataExchangeMessageFromMasterNode
СообщениеОНеудачномОбновлении=FailedUpdateMessage
Сообщения=Messages
СообщенияАдминистрированиеОбменаДаннымиКонтрольИнтерфейс=MessagesDataExchangeAdministrationControlInterface
СообщенияАдминистрированиеОбменаДаннымиКонтрольОбработчикСообщения_2_1_2_1=MessagesDataExchangeAdministrationControlMessageHandler_2_1_2_1
СообщенияАдминистрированиеОбменаДаннымиУправлениеИнтерфейс=MessagesDataExchangeAdministrationManagementInterface
СообщенияАдминистрированиеОбменаДаннымиУправлениеОбработчикСообщения_2_1_2_1=MessagesDataExchangeAdministrationManagementMessageHandler_2_1_2_1
СообщенияКонтрольДополнительныхОтчетовИОбработокИнтерфейс=MessagesAdditionalReportsAndDataProcessorsControlInterface
СообщенияКонтрольДополнительныхОтчетовИОбработокОбработчикТрансляции_1_0_0_1=MessagesAdditionalReportsAndDataProcessorsControlTranslationHandler_1_0_0_1
СообщенияОбменаДанными=DataExchangeMessages
СообщенияОбменаДаннымиКонтрольИнтерфейс=DataExchangeMessagesControlInterface
СообщенияОбменаДаннымиКонтрольОбработчикСообщения_2_1_2_1=DataExchangeMessagesControlMessageHandler_2_1_2_1
СообщенияОбменаДаннымиОбластейДанных=DataAreasDataExchangeMessages
СообщенияОбменаДаннымиОбработчикСообщения=DataExchangeMessagesMessageHandler
СообщенияОбменаДаннымиУправлениеИнтерфейс=DataExchangeMessagesManagementInterface
СообщенияОбменаДаннымиУправлениеОбработчикСообщения_2_1_2_1=DataExchangeMessagesManagementMessageHandler_2_1_2_1
СообщенияОбменаДаннымиУправлениеОбработчикСообщения_3_0_1_1=DataExchangeMessagesManagementMessageHandler_3_0_1_1
СообщенияОбменаДаннымиУправлениеОбработчикТрансляции_2_1_2_1=DataExchangeMessagesManagementTranslationHandler_2_1_2_1
СообщенияУправленияДОИООбработчикСообщения_1_0_1_1=AdditionalReportsAndDataProcessorsManagementMessagesMessageHandler_1_0_1_1
СообщенияУправленияДОИООбработчикСообщения_1_0_1_2=AdditionalReportsAndDataProcessorsManagementMessagesMessageHandler_1_0_1_2
СообщенияУправленияДополнительнымиОтчетамиИОбработкамиИнтерфейс=AdditionalReportsAndDataProcessorsManagementMessagesInterface
СообщенияУправленияДополнительнымиОтчетамиИОбработкамиРеализация=AdditionalReportsAndDataProcessorsManagementMessagesImplementation
СоответствияОбъектовИнформационныхБаз=InfobaseObjectsMaps
СопоставлениеОбъектовИнформационныхБаз=InfobasesObjectsMapping
СортироватьСтрокиПоВозрастанию=SortRowsAsc
СортироватьСтрокиПоУбыванию=SortRowsDesc
Состав=Content
СоставВыгрузки=ExportComposition
СоставКомплексногоВопроса=ComplexQuestionComposition
Составной=Composite
СоставОтправляемыхДанных=DataToSendComposition
СоставПолей=FieldsComposition
СоставТабличногоВопроса=TableQuestionComposition
СоставыГруппПользователей=UserGroupCompositions
СостояниеБизнесПроцесса=BusinessProcessState
СостояниеОбменаДанными=DataExchangeState
СостояниеОбменаДаннымиОшибка=DataExchangeStateError
СостояниеОригиналаПервичногоДокументаОригиналНеПолучен=SourceDocumentOriginalStateOriginalNotReceived
СостояниеОригиналаПервичногоДокументаОригиналПолучен=SourceDocumentOriginalStateOriginalReceived
СостояниеПользователя01=UserState01
СостояниеПользователя02=UserState02
СостояниеПользователя03=UserState03
СостояниеПользователя04=UserState04
СостояниеПользователя05=UserState05
СостояниеПользователя06=UserState06
СостояниеПользователя07=UserState07
СостояниеПользователя08=UserState08
СостояниеПользователя09=UserState09
СостояниеПользователя10=UserState10
СостояниеПользователя11=UserState11
СостояниеПользователя12=UserState12
СостояниеРассылкиОтчетов=ReportMailingState
СостояниеСообщения=MessageState
СостоянияБизнесПроцессов=BusinessProcessStates
СостоянияДокументаСообщениеSMS=SMSDocumentStatuses
СостоянияЗапросовНаИспользованиеВнешнихРесурсов=RequestsToUseExternalResourcesStates
СостоянияКонтактовВзаимодействий=InteractionsContactStates
СостоянияОбменовДанными=DataExchangesStates
СостоянияОбменовДаннымиОбластейДанных=DataAreaDataExchangeStates
СостоянияОригиналовПервичныхДокументов=SourceDocumentsOriginalsStates
СостоянияПапокПисем=EmailFolderStates
СостоянияПользователей=UsersStates
СостоянияПредметовВзаимодействий=InteractionsSubjectsStates
СостоянияПроверокВеденияУчета=AccountingChecksStates
СостоянияПроцессов=ProcessesStates
СостоянияПроцессовДляЗапуска=ProcessesStatesForStart
СостоянияРассылокОтчетов=ReportMailingStates
СостоянияРасширенийБудетПодключено=ExtensionStatesWillBeConnected
СостоянияРасширенийКонфигурации=ConfigurationExtensionStates
СостоянияРасширенийОшибка=ExtensionStatesError
СостоянияРасширенийПодключено=ExtensionStatesAttached
СостоянияСообщенияSMS=SMSMessagesState
СостоянияУспешныхОбменовДанными=SuccessfulDataExchangesStates
СостоянияУспешныхОбменовДаннымиОбластейДанных=DataAreasSuccessfulDataExchangeStates
Сотрудник=Employee
СохранениеВариантаОтчета=ReportOptionSave
СохранениеВариантаОтчетаВФайл=SaveReportOptionToFile
СохранениеВместеСЭлектроннойПодписью=SaveWithDigitalSignature
СохранениеДанныхПользователя=SaveUserData
СохранениеПечатнойФормы=SavePrintForm
СохраненныеНастройки=SavedSettings
СохранитьВариантОтчета=SaveReportOption
СохранитьКак=SaveAs
СохранитьПисьмоНаДиск=SaveEmailToHardDrive
СохранитьФайлКак=SaveFileAs
СОшибками=WithErrors
СпискиСОграничениемПоПолям=ListsWithRestrictionByFields
СпискиСОграничениемЧерезКлючиДоступаГруппДоступа=ListsWithAccessGroupsAccessKeysRestriction
СпискиСОграничениемЧерезКлючиДоступаПользователей=ListsWithUsersAccessKeysRestriction
СпискиСОтключеннымОграничениемЧтения=ListsWithReadRestrictionDisabled
Список=List
СписокДополнениеКВыгрузке=ListExportAddition
СписокЗанятыхСВопросом=LockedFilesListWithQuestion
СписокЗапрещенныхРасширений=DeniedExtensionsList
СписокЗапрещенныхРасширенийОбластиДанных=DeniedDataAreaExtensionsList
СписокИспользуемыхПолей=UsedFieldsList
СписокПолейТаблицы=TableFieldsList
СписокПолучателейКопий=CcRecipientsList
СписокПолучателейПисьма=EmailRecipientsList
СписокПолучателейСкрытыхКопий=BccRecipientsList
СписокПользователей=UsersList
СписокРасширенийТекстовыхФайлов=TextFilesExtensionsList
СписокРасширенийФайловOpenDocument=FilesExtensionsListOpenDocument
СписокРасширенийФайловOpenDocumentОбластиДанных=FilesExtensionsListDocumentDataAreas
СписокУчастников=ParticipantsList
СпособВыполнения=RunMethod
СпособЗаполнения=FillingMethod
СпособОтображенияПодсказки=HintPlacement
СпособУстановкиВремениНапоминания=ReminderTimeSettingMethod
СпособУстановкиКурса=RateSource
СпособХраненияФайлов=FilesStorageMethod
СпособыВызоваДополнительныхОбработок=AdditionalDataProcessorsCallMethods
СпособыВыполненияПроверки=CheckMethod
СпособыЗаполненияГрафикаРаботы=WorkScheduleFillingMethods
СпособыОткрытияФайлаНаПросмотр=OpenFileForViewingMethods
СпособыОтображенияПодсказок=TooltipDisplayMethods
СпособыПоворотаИзображения=PictureRotationOptions
СпособыРедактированияЭлектронныхПисем=EmailEditingMethods
СпособыСравненияВерсийФайлов=FileVersionsComparisonMethods
СпособыУстановкиВремениНапоминания=ReminderTimeSettingMethods
СпособыУстановкиКурсаВалюты=RateSources
СправкаВНачало=HelpHomePage
СправкаПереходВниз=HelpMoveDown
СправочникПВХКоннекторВверх=CCTCatalogConnectorUp
СправочникПВХКоннекторВерхНиз=CatalogCCTConnectorTopBottom
СправочникПВХКоннекторЛево=CatalogCCTConnectorLeft
СправочникПВХКоннекторЛевоВерх=CatalogCCTConnectorLeftTop
СправочникПВХКоннекторЛевоНиз=CatalogCCTConnectorLeftBottom
СправочникПВХКоннекторНиз=CatalogCCTConnectorBottom
СправочникПВХПомеченНаУдалениеКоннекторВерх=CatalogCCTMarkedForDeletionConnectorTop
СправочникПВХПомеченНаУдалениеКоннекторВерхНиз=CatalogCCTMarkedForDeletionConnectorTopBottom
СправочникПВХПомеченНаУдалениеКоннекторЛево=CatalogCCTMarkedForDeletionConnectorLeft
СправочникПВХПомеченНаУдалениеКоннекторЛевоВерх=CatalogCCTMarkedForDeletionConnectorLeftTop
СправочникПВХПомеченНаУдалениеКоннекторЛевоНиз=CatalogCCTMarkedForDeletionConnectorLeftBottom
СправочникПВХПомеченНаУдалениеКоннекторНиз=CatalogCCTMarkedForDeletionConnectorBottom
СправочникПользователи=CatalogUsers
СравнениеТабличныхДокументов=CompareSpreadsheetDocuments
Среднее=AVG
СрокДействия=ValidityPeriod
СрокДействияНеОграничен=UnlimitedValidityPeriod
СрокИсполнения=TaskDueDate
СрокиХраненияВерсий=VersionsLifetimes
СрокНапоминания=ReminderTime
СрокПроверки=VerificationDueDate
СрокХраненияВерсий=VersionLifetime
Ссылка=Ref
СсылкаДляПереходаПриВозникновенииОшибки=LinkToGoToOnError
СсылкаНового=RefToNew
СтандартноеЗначение=StandardValue
СтандартныеПодсистемы=StandardSubsystems
СтандартныеПодсистемыВАвтономномРежиме=StandardSubsystemsStandaloneMode
СтандартныеПодсистемыВЛокальномРежиме=StandardSubsystemsLocalMode
СтандартныеПодсистемыВМоделиСервиса=StandardSubsystemsSaaS
СтандартныеПодсистемыВызовСервера=StandardSubsystemsServerCall
СтандартныеПодсистемыГлобальный=StandardSubsystemsGlobal
СтандартныеПодсистемыКлиент=StandardSubsystemsClient
СтандартныеПодсистемыКлиентПовтИсп=StandardSubsystemsClientCached
СтандартныеПодсистемыКлиентСерверЛокализация=StandardSubsystemsClientServerLocalization
СтандартныеПодсистемыПовтИсп=StandardSubsystemsCached
СтандартныеПодсистемыСервер=StandardSubsystemsServer
Стандартный=Standard
СтандартныйМакетПредставленияОбъекта=StandardObjectPresentationTemplate
СтандартнымПриложением=UsingStandardApplication
Стартован=Started
СтартОтложенныхПроцессов=StartDeferredProcesses
СтартОтменен=StartCanceled
СтаршеГода=OverOneYear
СтаршеМесяца=OverOneMonth
СтаршеШестиМесяцев=OverSixMonths
СтатистикаВыполнения=ExecutionStatistics
СтатистикаКонфигурации=ConfigurationStatistics
Статус=Status
СтатусИзвлеченияТекста=TextExtractionStatus
СтатусИсходящегоПисьма=OutgoingEmailStatus
СтатусОбновленияКонфигурации=ConfigurationUpdateStatus
СтатусПисьма=EmailStatus
СтатусПроблемы=IssueStatus
СтатусыДокумента=DocumentStatuses
СтатусыИзвлеченияТекстаФайлов=FileTextExtractionStatuses
СтатусыИсходящегоЭлектронногоПисьма=OutgoingEmailStatuses
СтатусыОбработчиковОбновления=UpdateHandlersStatuses
СтатусыСинхронизацииФайловСОблачнымСервисом=FilesSynchronizationWithCloudServiceStatuses
СтатусыСопоставленияОбъектов=ObjectMappingStatuses
Страна=Country
СтраныМира=WorldCountries
СтрелкаВверх=UpArrow
СтрелкаВлево=LeftArrow
СтрелкаВниз=DownArrow
СтрелкаВнизЗеленая=GreenDownArrow
СтрелкаВнизСправка=HelpDownArrow
СтрелкаВправо=RightArrow
СтрелкаВправоЗеленая=GreenRightArrow
СтрелкаВправоКрасная=RedRightArrow
Строка=String
СтроковыеКонтактыВзаимодействий=StringContactInteractions
СтроковыеФункции=StringFunctions
СтроковыеФункцииКлиент=StringFunctionsClient
СтроковыеФункцииКлиентСервер=StringFunctionsClientServer
Структура=Structure
СтруктураПодчиненности=SubordinationStructure
СтруктураПодчиненностиПереопределяемый=SubordinationStructureOverridable
СтруктураПодчиненностиСлужебный=SubordinationStructureInternal
Суббота=Saturday
Сумма=Sum
СуммаЗначений=ValueSum
СформироватьСообщение=GenerateMessage
СхемаКомпоновкиДанных=DataCompositionSchema
СхемаОтборВзаимодействия=SchemaInteractionsFilter
СхемаОтборВзаимодействияКонтакт=SchemaFilterInteractionsContact
СхемаПравилаОбработкиЭлектроннойПочты=EmailProcessingRuleScheme
СхемаРоли=RoleSchema
СценарииОбменовДанными=DataExchangeScenarios
СценарииСинхронизации=SynchronizationScenarios
СценарийВБезопасномРежиме=SafeModeScenario
СчетчикЗагруженныхОбъектовВнешнееСоединение=ImportedObjectCounterExternalConnection
СчетчикПроблемВеденияУчета=AccountingIssuesCounter
Таблица=Table
ТаблицаАвтоматическиСопоставленныхОбъектов=AutomaticallyMappedObjectsTable
ТаблицаНастройкиПараметров=ParametersSetupTable
ТаблицаНеутвержденныхСвязей=UnapprovedMappingTable
ТаблицаПравилВыгрузки=ExportRulesTable
ТаблицаПравилКонвертации=ConversionRulesTable
ТаблицаПравилОчистки=CleanupRulesTable
ТаблицаСортировки=SortTable
ТаблицыГруппДоступа=AccessGroupsTables
ТаблицыРасширенийСОграничениемДоступа=TableOfExtensionsWithAccessRestriction
ТаблицыСОтдельнымиНастройкамиПрав=TablesWithIndividualRightsSettings
ТабличнаяЧасть1=TabularSection1
ТабличнаяЧасть2=TabularSection2
ТабличнаяЧасть3=TabularSection3
ТабличнаяЧасть4=TabularSection4
ТабличныеФайлы=SpreadsheetFiles
Табличный=Tabular
Текст=Text
ТекстHTML=HTMLText
ТекстЗапрещеннойЯчейкиЦвет=InaccessibleCellTextColor
ТекстоваяСтрока=TextString
ТекстовыеФайлы=TextFiles
ТекстОшибки=ErrorText
ТекстПисьма=EmailText
ТекстПисьмаВФорматеHTML=EmailTextInHTMLFormat
ТекстСодержания=ContentText
ТекстСообщения=MessageText
ТекстХранилище=TextStorage
ТекстШаблонаSMS=SMSTemplateText
ТекстШаблонаПисьма=MessageTemplateText
ТекстШаблонаПисьмаHTML=HTMLEmailTemplateText
ТекущаяВерсия=CurrentVersion
ТекущиеДела=ToDoList
ТекущиеДелаЗаголовокДочернегоДела=ToDoListChildToDoTitle
ТекущиеДелаЗаголовокРазделаШрифт=ToDoListSectionTitleFont
ТекущиеДелаПереопределяемый=ToDoListOverridable
ТекущиеДелаСервер=ToDoListServer
ТекущиеДелаСлужебный=ToDoListInternal
ТекущиеДелаСлужебныйПовтИсп=ToDoListInternalCached
ТекущийВнешнийПользователь=CurrentExternalUser
ТекущийПользователь=CurrentUser
Телеграм16х16=Telegram16x16
Телефон=Phone
ТелефонCДобавочнымНомером=PhoneWithExtension
ТелефонныйЗвонок=PhoneCall
ТелефонныйЗвонокПрисоединенныеФайлы=PhoneCallAttachedFiles
ТелефонПользователя=UserPhone
Телефоны=Phones
ТелоПакета=PackageBody
ТелоРазрешения=PermissionBody
Тема=Subject
ТемаПисьма=EmailSubject
ТеснаяИнтеграцияСФормойОтчета=DeepIntegrationWithReportForm
ТехническийПроект=TechnicalDesign
Тип=Type
ТипБулево=BooleanType
ТипВедущейТаблицы=LeadingTableType
ТипВерсииОбъекта=ObjectVersionType
ТипВерсионируемогоОбъекта=VersionizedObjectType
ТипВладельца=OwnerType
ТипВладельцаФайла=FileOwnerType
ТипВопроса=QuestionType
ТипГиперссылка=HyperlinkType
ТипГруппа=TypeGroup
ТипДанных=DataType
ТипДата=DateType
ТипДерево=TypeTree
ТипЗаписи=EntryType
ТипЗапрещенный=ProhibitedType
ТипЗначенийДоступа=AccessValuesType
ТипИдентификатор=TypeID
ТипИнформационнойБазыДляПодключения=InfobaseToConnectType
ТипИсточника=SourceType
ТипИсточникаСтрокой=SourceTypeString
ТипКартинка=TypePicture
ТипКонстанта=TypeConstant
ТипМакрос=TypeMacro
ТипНеопределено=TypeUndefined
ТипОбъекта=ObjectType
ТипОбъектаСтрокой=ObjectTypeString
ТипОграничения=RestrictionType
ТипОперации=OperationType
ТипОтвета=ReplyType
ТипОтчета=ReportType
ТипПапка=FolderType
ТипПараметра=ParameterType
ТипПолучателейРассылки=MailingRecipientType
ТипПользователей=UsersType
ТипПредопределеннойПапки=PredefinedFolderType
ТипПриемника=DestinationType
ТипПриемникаСтрокой=DestinationTypeString
ТипПроблемы=IssueType
ТипПрограммногоМодуля=ProgramModuleType
ТипПрограммы=ApplicationType
ТипРазрешенный=ValidType
ТипРеспондентов=RespondentsType
ТипСоставнойДополнительный=TypeFlexibleAdditional
ТипСоставнойОсновной=TypeFlexibleMain
ТипСписок=TypeList
ТипСсылка=TypeRef
ТипСтрока=StringType
ТипТаблицы=TableType
ТипТабличногоВопроса=TabularQuestionType
ТипТекста=TextType
ТипТекстаПисьма=EmailTextType
ТипУдаленияРегистрацииИзмененийДляУзловОбменаПослеВыгрузки=ChangesRegistrationDeletionTypeForExportedExchangeNodes
ТипФильтр=TypeFilter
ТипФормы=FormType
ТипФункция=TypeFunction
ТипХраненияФайла=FileStorageType
ТипЧисло=NumberType
ТипыВерсийОбъекта=ObjectVersionTypes
ТипыВладельцевНастроекПрав=RightsSettingsOwnersTypes
ТипыВопросовШаблонаАнкеты=QuestionnaireTemplateQuestionTypes
ТипыДанныхКэшаПрограммныхИнтерфейсов=APICacheDataTypes
ТипыДополнительногоОбъектаАдресации=AdditionalAddressingObjectTypes
ТипыЗначенийДоступаСГруппами=AccessValuesTypesWithGroups
ТипыКонтактнойИнформации=ContactInformationTypes
ТипыМакетов=TemplateTypes
ТипыОсновногоОбъектаАдресации=MainAddressingObjectTypes
ТипыОтветовНаВопрос=TypesOfAnswersToQuestion
ТипыОтчетов=ReportsTypes
ТипыПредопределенныхПапокПисем=PredefinedEmailsFoldersTypes
ТипыПроблемОбменаДанными=DataExchangeIssuesTypes
ТипыТабличныхВопросов=TabularQuestionTypes
ТипыТекстовЭлектронныхПисем=EmailTextTypes
ТипыФайловДляВстроенногоРедактора=BuiltInEditorFileTypes
ТипыХраненияФайлов=FileStorageTypes
ТипЭлементовНабора=SetItemsType
ТолстаяГраницаВокруг=ThickOutsideBorder
ТолстаяГраницаСверху=ThickTopBorder
ТолстаяГраницаСнизу=ThickBottomBorder
ТолькоДляАвтора=AuthorOnly
ТолькоНациональныйАдрес=OnlyNationalAddress
ТолькоУведомить=NotifyOnly
Том=Volume
ТомаХраненияФайлов=FileStorageVolumes
ТочечноеЗадание=SpotJob
Точность=Accuracy
ТранслитерироватьИменаФайлов=TransliterateFileNames
ТранспортСообщенийОбменаEMAIL=ExchangeMessageTransportEMAIL
ТранспортСообщенийОбменаFILE=ExchangeMessageTransportFILE
ТранспортСообщенийОбменаFTP=ExchangeMessageTransportFTP
ТребуетОткрытогоОтвета=OpenEndedQuestion
ТребуетсяВходНаСерверПередОтправкой=SignInBeforeSendingRequired
ТребуетсяКомментарий=CommentRequired
ТребуетсяОтправка=SendingRequired
Тумблер=Tumbler
УведомитьОДоставке=RequestDeliveryReceipt
УведомитьОПрочтении=RequestReadReceipt
УведомлениеИсполнителейОНовыхЗадачах=NewPerformerTaskNotifications
УведомленияОПрочтении=ReadReceipts
УвеличитьШрифт=IncreaseFont
Удаление=Delete
УдалениеЛишнихФайловИзТома=DeleteUnnecessaryFilesFromVolume
УдалениеНазначения=AssignmentDeletion
УдалениеНастройкиСинхронизации=DeleteSyncSetting
УдалениеНеактуальнойИнформацииСинхронизации=ObsoleteSynchronizationDataDeletion
УдалениеПомеченных=DeleteMarkedObjects
УдалениеПомеченныхОбъектов=MarkedObjectsDeletion
УдалениеПомеченныхОбъектовКлиент=MarkedObjectsDeletionClient
УдалениеПомеченныхОбъектовПереопределяемый=MarkedObjectsDeletionOverridable
УдалениеПомеченныхОбъектовСлужебный=MarkedObjectsDeletionInternal
УдалениеПомеченныхОбъектовСлужебныйВызовСервера=MarkedObjectsDeletionInternalServerCall
УдалениеПомеченныхОбъектовСлужебныйКлиентСервер=MarkedObjectsDeletionInternalClientServer
УдалениеПомеченныхПовтИсп=DeleteMarkedObjectsCached
УдалениеУстаревшихПараметровРаботыВерсийРасширений=DeleteObsoleteExtensionsVersionsParameters
УдалениеУстаревшихПредупреждений=ObsoleteWarningsDeletion
Удаленные=Trash
УдаленныйДоступOData=RemoteODataAccess
УдаленныйДоступБазоваяФункциональность=RemoteAccessCore
УдаленныйДоступОбменДаннымиВМоделиСервиса=RemoteAccessDataExchangeSaaS
УдаленныйКонтроль=RemoteControl
УдаленныйРеквизитФон=DeletedAttributeBackground
УдалитьCOMПарольПользователя=DeleteCOMUserPassword
УдалитьFTPСоединениеПароль=DeleteFTPConnectionPassword
УдалитьWSПароль=DeleteWSPassword
УдалитьДокумент_Встреча=DeleteDocument_Meeting
УдалитьДокумент_ЗапланированноеВзаимодействие=DeleteDocument_ScheduledInteraction
УдалитьДокумент_СообщениеSMS=DeleteDocument_SMS
УдалитьДокумент_ТелефонныйЗвонок=DeleteDocument_PhoneCall
УдалитьДокумент_ЭлектронноеПисьмоВходящее=DeleteDocument_IncomingEmail
УдалитьДокумент_ЭлектронноеПисьмоИсходящее=DeleteDocument_OutgoingEmail
УдалитьЗамерыВремени3=DeleteTimeMeasurements3
УдалитьЗашифрован=DeleteEncrypted
УдалитьИгнорироватьПроблему=DeleteIgnoreIssue
УдалитьИдентификаторСообщенияОтправкаIMAP=DeleteMessageIDSendIMAP
УдалитьНастройкиТранспортаОбмена=DeleteExchangeTransportSettings
УдалитьНастройкуСинхронизации=DeleteSynchronizationSetting
УдалитьНоваяСсылка=DeleteNewRef
УдалитьОбработкаПерсональныхДанных=DeletePersonalDataProcessing
УдалитьПарольАрхиваСообщенияОбмена=DeleteExchangeMessageArchivePassword
УдалитьПерсональнаяУчетнаяЗапись=DeletePersonalAccount
УдалитьПодписанЭП=DeleteSignedDigitalSignature
УдалитьПолноеНаименование=DeleteFullDescription
УдалитьПользовательДляСинхронизацииДанных=DeleteUserForDataSync
УдалитьРедактированиеТолькоВДиалоге=DeleteEditInDialogOnly
УдалитьРезультатыОбменаДанными=DeleteDataExchangeResults
УдалитьСертификатыШифрования=DeleteEncryptionCertificates
УдалитьСправочник_ВнешниеПользователи=DeleteCatalog_ExternalUsers
УдалитьСправочник_ПапкиФайлов=DeleteCatalog_FilesFolders
УдалитьСправочник_Пользователи=DeleteCatalog_Users
УдалитьСправочник_Файлы=DeleteCatalog_Files
УдалитьТекущаяВерсияДатаМодификацииФайла=DeleteCurrentVersionFileModificationDate
УдалитьТекущаяВерсияДатаСоздания=DeleteCurrentVersionCreationDate
УдалитьТекущаяВерсияКод=DeleteCurrentVersionCode
УдалитьТекущаяВерсияНомерВерсии=DeleteCurrentVersionVersionNumber
УдалитьУзелОбменаДанными=DeleteDataExchangeNode
УдалитьХранимыеФайлыВерсий=DeleteStoredVersionFiles
УдалитьЭлектронныеПодписи=DeleteDigitalSignatures
УдаляемыеОбъекты=ObjectsToDelete
УдаляемыеРазрешения=PermissionsToDelete
УдалятьПисьмаПослеОтправки=DeleteEmailsAfterSend
УдалятьПослеОтправки=DeleteAfterSend
Удовлетворительно=Tolerated
Узел=Node
УзелДляОбмена=NodeForExchange
УзелДляФоновогоОбмена=BackgroundExchangeNode
УзелИнформационнойБазы=InfobaseNode
УзелОбмена=ExchangeNode
УзелОбменаЗагрузкаДанных=ExchangeNodeDataImport
УзелОбменаЗагрузкаФоновыхДанных=ExchangeNodeBackgroundDataImport
УзелПланаОбмена=ExchangePlanNode
УзлыРегистрацииОбъекта=ObjectRegistrationNodes
УменьшитьШрифт=DecreaseFont
УниверсальныйОбменДанными=UniversalDataExchange
УниверсальныйОбменДаннымиXML=UniversalDataExchangeXML
УниверсальныйОтчет=UniversalReport
УникальныйИдентификатор=UUID
УникальныйИдентификатор1С=UUID1C
УникальныйИдентификаторИсточника=SourceUUID
УникальныйИдентификаторИсточникаСтрокой=SourceUUIDString
УникальныйИдентификаторПриемника=DestinationUUID
УпаковатьВАрхив=PackToArchive
УправлениеДоступом=AccessManagement
УправлениеДоступомВМоделиСервиса=AccessManagementSaaS
УправлениеДоступомПереопределяемый=AccessManagementOverridable
УправлениеДоступомСлужебный=AccessManagementInternal
УправлениеДоступомСлужебныйВМоделиСервиса=AccessManagementInternalSaaS
УправлениеДоступомСлужебныйВызовСервера=AccessManagementInternalServerCall
УправлениеДоступомСлужебныйКлиент=AccessManagementInternalClient
УправлениеДоступомСлужебныйКлиентСервер=AccessManagementInternalClientServer
УправлениеДоступомСлужебныйПовтИсп=AccessManagementInternalCached
УправлениеИтогамиИАгрегатами=TotalsAndAggregatesManagement
УправлениеИтогамиИАгрегатамиСлужебный=TotalsAndAggregatesManagementInternal
УправлениеКолонтитулами=HeaderFooterManagement
УправлениеКонтактнойИнформацией=ContactsManager
УправлениеКонтактнойИнформациейКлиент=ContactsManagerClient
УправлениеКонтактнойИнформациейКлиентСервер=ContactsManagerClientServer
УправлениеКонтактнойИнформациейПереопределяемый=ContactsManagerOverridable
УправлениеКонтактнойИнформациейСлужебный=ContactsManagerInternal
УправлениеКонтактнойИнформациейСлужебныйВызовСервера=ContactsManagerInternalServerCall
УправлениеКонтактнойИнформациейСлужебныйПовтИсп=ContactsManagerInternalCached
УправлениеОбработчиками=HandlerManagement
УправлениеПечатью=PrintManagement
УправлениеПечатьюMSWordКлиент=PrintManagementMSWordClient
УправлениеПечатьюOOWriterКлиент=PrintManagementOOWriterClient
УправлениеПечатьюВызовСервера=PrintManagementServerCall
УправлениеПечатьюКлиент=PrintManagementClient
УправлениеПечатьюКлиентПереопределяемый=PrintManagementClientOverridable
УправлениеПечатьюКлиентСервер=PrintManagementClientServer
УправлениеПечатьюМультиязычность=PrintManagementNationalLanguageSupport
УправлениеПечатьюМультиязычностьКлиент=PrintManagementNationalLanguageSupportClient
УправлениеПечатьюПереопределяемый=PrintManagementOverridable
УправлениеПечатьюСлужебный=PrintManagementInternal
УправлениеПечатьюСлужебныйКлиент=PrintManagementInternalClient
УправлениеПолнотекстовымПоискомИИзвлечениемТекстов=FullTextSearchAndTextExtractionControl
УправлениеСвойствами=PropertyManager
УправлениеСвойствамиКлиент=PropertyManagerClient
УправлениеСвойствамиПереопределяемый=PropertyManagerOverridable
УправлениеСвойствамиПовтИсп=PropertyManagerCached
УправлениеСвойствамиСлужебный=PropertyManagerInternal
УправлениеЭлектроннойПочтой=EmailManagement
УправлениеЭлектроннойПочтойКлиент=EmailManagementClient
УправляемаяФорма=ManagedForm
УправляемаяФормаНастройкиОтладкиОбработчиков=HandlerDebugSetupManagedForm
УровеньЗапрещенияИзменения=ChangingProhibitionLevel
УровеньЗапрещенияПрава=RightProhibitionLevel
УровеньЗапрещенияЧтения=ReadingProhibitionLevel
УровеньИспользования=UsageLevel
УровеньРазрешенияИзменения=ChangingPermissionLevel
УровеньРазрешенияПрава=RightPermissionLevel
УровеньРазрешенияЧтения=ReadingPermissionLevel
УровниПроизводительности=PerformanceLevels
УсиленнаяЗащитаЗакрытогоКлюча=StrongPrivateKeyProtection
Условие=Condition
УсловияОтборовОтчета=ReportFiltersConditions
УсловияРаспространенияОбновлений=UpdateDistributionTerms
Успешно=Success
Успешно32=Success32
УспешныйЗапуск=SuccessfulStart
УстановившийПодпись=SignatureSetBy
УстановитьБлокировкуУзлаПланаОбмена=SetExchangePlanNodeLock
УстановитьОтветственногоЗаВзаимодействие=SetPersonResponsibleForInteraction
УстановитьПометкуУдаленияЗадач=MarkTasksForDeletion
УстановитьПометкуУдаленияПрисоединенныхФайлов=SetAttachedFilesDeletionMarks
УстановитьПометкуУдаленияПрисоединенныхФайловДокументовВзаимодействия=SetDeletionMarkForInteractionsDocumentAttachments
УстановитьПредметВзаимодействия=SetInteractionSubject
УстановитьПризнакРассмотреноДляВзаимодействия=SetReviewedFlagForInteraction
УстановитьРасширениеДляРаботыС1СПредприятием=Install1CEnterpriseExtension
УстановитьРолиНепосредственно=SetRolesDirectly
УстановитьСнятьПометкуУдаленияЗаметок=SetClearNotesDeletionMark
УстановитьСостояниеОригиналаПервичногоДокумента=SetSourceDocumentOriginalState
УстановитьСтатусИзмененияПометкиУдаленияПользователя=SetUserDeletionNoteChangeStatus
УстановкаВнешнейКомпонентыНевозможна=CannotInstallAddIn
УстановкаОбновлений=InstallUpdates
УстановкаПериодаРассчитанныхИтогов=TotalsPeriodSetup
УстановленныеИсправления=InstalledPatches
УстановленныеРасширения=InstalledExtensions
Уточнение=Refinement
УточнениеКонтактов=ContactsClarification
УточнениеКонтекстаПроверокВеденияУчета=AccountingCheckContextClarification
УточнениеПроблемы=IssueSummary
УточнитьСостояниеОригиналаПервичногоДокументаПоПечатнымФормам=SetSourceDocumentOriginalStateByPrintForms
УчастникЕАЭС=EEUMember
Участники=Attendees
УчетнаяЗапись=Account
УчетнаяЗаписьДляВосстановленияПароля=PasswordRecoveryAccount
УчетнаяЗаписьЭлектроннойПочты=EmailAccount
УчетныеЗаписиСинхронизацииФайлов=FileSynchronizationAccounts
УчетныеЗаписиЭлектроннойПочты=EmailAccounts
УчетОригиналовПервичныхДокументов=SourceDocumentsOriginalsRecording
УчетОригиналовПервичныхДокументовВызовСервера=SourceDocumentsOriginalsRecordingServerCall
УчетОригиналовПервичныхДокументовКлиент=SourceDocumentsOriginalsRecordingClient
УчетОригиналовПервичныхДокументовКлиентПереопределяемый=SourceDocumentsOriginalsRecordingClientOverridable
УчетОригиналовПервичныхДокументовПереопределяемый=SourceDocumentsOriginalsRecordingOverridable
УчитыватьНерабочиеПериоды=ConsiderNonWorkPeriods
УчитыватьПраздники=ConsiderHolidays
Файл=File
ФайлЗагрузкиРезервнойКопии=BackupImportFile
ФайлЗанятыйТекущимПользователем=FileLockedByCurrentUser
ФайловаяСистема=FileSystem
ФайловаяСистемаКлиент=FileSystemClient
ФайловаяСистемаСлужебныйКлиент=FileSystemInternalClient
ФайловаяСистемаСлужебныйКлиентСервер=FileSystemInternalClientServer
ФайлСуществует=FileExists
ФайлХранилище=FileStorage
Файлы=Files
ФайлыВРабочемКаталоге=FilesInWorkingDirectory
ФайлыВТоме=FilesInVolume
Факс=Fax
Фамилия=LastName
ФизическоеЛицо=Individual
Финансовый=Fiscal
Фиолетовый=Violet
Фирма=Firm
ФлагОшибки=ErrorFlag
ФлагРежимОтладки=FlagDebugMode
ФлагРежимОтладкиОбработчиков=HandlersDebugModeFlag
Флажок=CheckBox
ФоновоеЗадание=BackgroundJob
ФонРезультатовПоиска=SearchResultsBackground
ФонУправляющегоПоля=MasterFieldBackground
Форма=Form
ФормаБизнесПроцесса=BusinessProcessForm
ФормаВариантаОтчета=ReportVariantForm
ФормаВозвратаФайла=SaveFileToInfobaseForm
ФормаВопроса=QuestionForm
ФормаВыбора=ChoiceForm
ФормаВыбораГруппы=GroupChoiceForm
ФормаВыбораИдентификаторовОбъектовМетаданных=MetadataObjectsIDsChoiceForm
ФормаВыбораПериода=PeriodChoiceForm
ФормаВыбораРежимаОткрытия=OpeningModeChoiceForm
ФормаВыбораСвязиСопоставления=MappingChoiceForm
ФормаВыбораСостояния=StateChoiceForm
ФормаГруппы=FolderForm
ФормаДобавленияУсловияПоДате=FormAddConditionByDate
ФормаДокумента=DocumentForm
ФормаЗавершениеРедактирования=FormFinishEditing
ФормаЗадачи=BusinessTaskForm
ФормаЗаписи=RecordForm
ФормаЗаписиНастройки=RecordFormSettings
ФормаИзвне=ExternalForm
ФормаИмпортаПапки=FolderImportForm
ФормаИмпортаФайлов=FilesImportForm
ФормаМастераКомплексныхВопросов=ComplexQuestionsWizardForm
ФормаМастераТабличныхВопросов=TableQuestionsWizardForm
ФормаНапечатана=FormPrinted
ФормаНастроекОтчета=ReportSettingsForm
ФормаНового=FormNewItem
ФормаОбработчика=HandlerForm
ФормаОповещения=NotificationForm
ФормаОтчета=ReportForm
ФормаПараметровПерестроения=RebuildParametersForm
ФормаПеретаскивания=DragForm
ФормаПодбора=PickForm
ФормаПодбораРеспондентов=FormSelectRespondents
ФормаПоиска=SearchForm
ФормаПростыхВопросов=BasicQuestionsForm
ФормаСписка=ListForm
ФормаСпискаОбработчиков=HandlersListForm
ФормаСпискаПараметрическая=ParametricListForm
Формат=Format
ФорматExcel=ExcelFormat
ФорматExcel2007=ExcelFormat2007
ФорматHTML=HTMLFormat
ФорматMXL=MXLFormat
ФорматOpenOfficeCalc=OpenOfficeCalcFormat
ФорматOpenOfficeWriter=OpenOfficeWriterFormat
ФорматPDF=PDFFormat
ФорматTXT=TXTFormat
ФорматWord=WordFormat
ФорматWord2007=WordFormat2007
ФорматВложений=AttachmentFormat
ФорматОбмена=ExchangeFormat
ФорматПодписиДляНовыхСообщений=NewMessageSignatureFormat
ФорматПодписиПриОтветеПересылке=ReplyForwardSignatureFormat
ФорматПустой=BlankFormat
ФорматСвойства=FormatProperties
ФорматыОтчетов=ReportFormats
ФорматыСканированногоИзображения=ScannedImageFormats
ФорматыСохраненияОтчетов=ReportSaveFormats
ФорматыХраненияМногостраничныхФайлов=MultipageFileStorageFormats
ФорматыХраненияОдностраничныхФайлов=SinglePageFileStorageFormats
ФормаЭкспортаПапки=ExportFolderForm
ФормаЭлемента=ItemForm
ФормированиеВнешнейСсылкиНаОбъект=ExternalObjectRefGeneration
ФормулаРасчетаКурса=RateCalculationFormula
Формулировка=Wording
Фотография=Photo
Фотокамера=Camera
Хеш=Hash
ХешНаименования=DescriptionHash
ХешНастроек=SettingsHash
ХешПакета=PackageHash
ХешСумма=HashSum
ХешСуммаПараметровШаблонов=TemplatesParametersHashSum
ХешСуммаПостоянныхПараметров=PersistentParametersHashSum
ХешСуммаРасширения=ExtensionHashsum
Хорошо=Good
ХранилищеВариантов=VariantsStorage
ХранилищеВариантовОтчетов=ReportsVariantsStorage
ХранилищеКомпоненты=AddInStorage
ХранилищеНастроек=SettingsStorage
ХранилищеОбработки=DataProcessorStorage
ХранилищеПараметра=ParameterStorage
ХранимыйФайл=StoredFile
ХранитьВерсии=StoreVersions
ХранитьИсториюИзменений=StoreChangeHistory
ХранитьФайлыВТомахНаДиске=StoreFilesInVolumesOnHardDrive
ЦветаЗаметок=NoteColors
ЦветИзмененногоПоля=ChangedFieldColor
Цветное=Colored
ЦветностиИзображения=ImageColorDepths
ЦветПустойГиперссылки=EmptyHyperlinkColor
ЦветРазделаПанелиФункций=FunctionsPanelSectionColor
ЦветТекста=TextColor
ЦветТекстаВнимание=WarningTextColor
ЦветТекстаНевыбраннойКартинки=NotSelectedPictureTextColor
ЦветТекстаОтрицательногоЗначения=NegativeValueTextColor
ЦветТекстаПоложительногоЗначения=PositiveValueTextColor
ЦветФона=BackColor
ЦветФонаВнимание=AttentionBackColor
ЦветФонаОтрицательногоЗначения=NegativeValueBackColor
ЦветФонаПоложительногоЗначения=PositiveValueBackColor
ЦветФонаПредупреждения=WarningBackColor
ЦелевоеВремя=ResponseTimeThreshold
ЦентрМониторинга=MonitoringCenter
ЦентрМониторингаГлобальный=MonitoringCenterGlobal
ЦентрМониторингаКлиент=MonitoringCenterClient
ЦентрМониторингаКлиентСлужебный=MonitoringCenterClientInternal
ЦентрМониторингаПереопределяемый=MonitoringCenterOverridable
ЦентрМониторингаПовтИсп=MonitoringCenterCached
ЦентрМониторингаСлужебный=MonitoringCenterInternal
ЧастичноДоставлено=PartiallyDelivered
Черновик=Draft
Черновики=Drafts
ЧислоПопыток=AttemptCount
ЧитаемыеОбъекты=ObjectsToRead
Чтение=Read
ЧтениеВариантовОтчетов=ReadReportOptions
ЧтениеВерсийОбъектов=ReadObjectVersions
ЧтениеВнешнихПользователей=ReadExternalUsers
ЧтениеГрафиковРаботы=ReadWorkSchedules
ЧтениеДополнительныхОтчетовИОбработок=ReadAdditionalReportsAndDataProcessors
ЧтениеДополнительныхСведений=ReadAdditionalInfo
ЧтениеЗаданий=ReadJobs
ЧтениеЗадач=ReadTasks
ЧтениеИнформацииОВерсияхОбъектов=ReadObjectVersionInfo
ЧтениеКурсовВалют=ReadCurrencyRates
ЧтениеОтветовНаВопросыАнкет=ReadQuestionnaireQuestionAnswers
ЧтениеРассылокОтчетов=ReadReportBulkEmails
ЧтениеРезультатовПроверкиУчета=ReadAccountingCheckResults
ЧтениеСостоянийОригиналовПервичныхДокументов=ReadSourceDocumentsOriginalsStates
ЧтениеУчетныхЗаписейЭлектроннойПочты=ReadEmailAccounts
ЧтениеШаблоновСообщений=ReadMessageTemplates
ШаблонАнкеты=QuestionnaireTemplate
ШаблонЗаполнения=FillingTemplate
ШаблонИмениФайлаСообщения=MessageFileNameTemplate
ШаблонПоВнешнейОбработке=TemplateByExternalDataProcessor
ШаблонСообщения=MessageTemplate
Шаблоны=Templates
ШаблоныАнкет=QuestionnaireTemplates
ШаблоныСообщений=MessageTemplates
ШаблоныСообщенийКлиент=MessageTemplatesClient
ШаблоныСообщенийКлиентСервер=MessageTemplatesClientServer
ШаблоныСообщенийПереопределяемый=MessageTemplatesOverridable
ШаблоныСообщенийПрисоединенныеФайлы=MessageTemplatesAttachedFiles
ШаблоныСообщенийСервер=MessageTemplatesServer
ШаблоныСообщенийСлужебный=MessageTemplatesInternal
ШаблоныСообщенийСлужебныйПовтИсп=MessageTemplatesInternalCached
Шаг=Step
Шапка=Header
ШиринаКолонки=ColumnWidth
Шифрование=Encryption
ШифрованиеДанных=DataEncryption
Шрифт=Font
Штамп=Stamp
Эксклюзивная=Exclusive
ЭкспортЗамеровПроизводительности=ExportPerformanceMeasurements
ЭкспортОценкиПроизводительности=PerformanceMonitorDataExport
ЭлектроннаяПодпись=DigitalSignature
ЭлектроннаяПодписьКлиент=DigitalSignatureClient
ЭлектроннаяПодписьКлиентПереопределяемый=DigitalSignatureClientOverridable
ЭлектроннаяПодписьКлиентСервер=DigitalSignatureClientServer
ЭлектроннаяПодписьКлиентСерверЛокализация=DigitalSignatureClientServerLocalization
ЭлектроннаяПодписьПереопределяемый=DigitalSignatureOverridable
ЭлектроннаяПодписьСлужебный=DigitalSignatureInternal
ЭлектроннаяПодписьСлужебныйВызовСервера=DigitalSignatureInternalServerCall
ЭлектроннаяПодписьСлужебныйКлиент=DigitalSignatureInternalClient
ЭлектроннаяПодписьСлужебныйКлиентСервер=DigitalSignatureInternalClientServer
ЭлектроннаяПодписьСлужебныйПовтИсп=DigitalSignatureInternalCached
ЭлектронноеПисьмо=EmailMessage
ЭлектронноеПисьмоВходящее=IncomingEmail
ЭлектронноеПисьмоВходящееПрисоединенныеФайлы=IncomingEmailAttachedFiles
ЭлектронноеПисьмоИсходящее=OutgoingEmail
ЭлектронноеПисьмоИсходящееПрисоединенныеФайлы=OutgoingEmailAttachedFiles
ЭлектронныеПодписи=DigitalSignatures
ЭлементарныйВопрос=ElementaryQuestion
ЭлементУсловногоОформленияОтчета=ConditionalReportAppearanceItem
ЭтоАвтономноеРабочееМесто=IsStandaloneWorkplace
ЭтоВладелецФайла=IsFileOwner
ЭтоВложениеПисьмо=IsAttachmentEmail
ЭтоДополнительноеСведение=IsAdditionalInfo
ЭтоЗапуск=IsStart
ЭтоИнтерактивныйРежим=IsInteractiveMode
ЭтоКлассификатор=IsClassifier
ЭтоНастройкаРаспределеннойИнформационнойБазы=IsDistributedInfobaseSetup
ЭтоНастройкаСтандартногоОбмена=IsStandardExchangeSetting
ЭтоНСИ=IsMasterData
ЭтоОсновнаяКонфигурация=IsMainConfiguration
ЭтоПраваНабораГрупп=AreGroupSetRights
ЭтоПрограммаОблачногоСервиса=IsCloudServiceApplication
ЭтоУдалениеОбъекта=IsObjectDeletion
ЭтоФайл=IsFile
ЯзыкиПечатныхФорм=PrintFormsLanguages
ЯзыкПеревода=TranslationLanguage
ЯндексКарты=YandexMaps
ЯндексПереводчик=YandexTranslate
