#Translations for: Перевод имен демонстрационных элементов форм. Используется только для перевода БСП.

_ДемоГруппаДругиеНастройкиСинхронизацииДанных=_DemoOtherDataSynchronizationSettingsGroup
_ДемоГруппаДругиеОбщиеНастройки=_DemoOtherCommonSettingsGroup
_ДемоГруппаИспользоватьКонтактныеЛицаПартнеров=_DemoUsePartnersContactPersonsGroup
_ДемоГруппаИспользоватьХарактеристики=_DemoUseCharacteristicsGroup
_ДемоГруппаОграниченияДоступаНаУровнеЗаписей=_DemoAccessRestrictionsOnRecordLevelGroup
_ДемоГруппаУчитыватьНДС=_DemoApplyVATGroup
_ДемоДругиеНастройкиСинхронизацииДанных=_DemoOtherDataSynchronizationSettings
_ДемоДругиеОбщиеНастройки=_DemoOtherCommonSettings
_ДемоИспользоватьХарактеристикиПриИзменении=_DemoUseCharacteristicsOnChange
_ДемоОграничиватьДоступПоПартнерамПредупреждение=_DemoRestrictAccessByPartnersWarning
_ДемоОткрытьГруппыДоступаНоменклатуры=_DemoOpenProductsAccessGroups
_ДемоОткрытьГруппыДоступаПартнеров=_DemoOpenPartnersAccessGroups
IDЗапроса=QueryID
URLОсобенностиПерехода=URLTransitionFeatures
URLСервиса=ServiceURL
URLСервисаЛичныйКабинет=ServiceURLPersonalAccount
URLФайлаОбновления=UpdateFileURL
АвтоматическиПоРасписанию=AutomaticallyOnSchedule
АвтоматическоеТестирование=AutoTesting
Автосохранение=AutoSave
АгентскиеУслугиКонтрагентГруппа=AgentServicesCounterpartyGroup
АгентскиеУслугиНомерСтроки=AgentServicesRowNumber
АдресВосстановления=RecoveryAddress
АдресДанныхВыгрузки=DataExportedDataAddress
АдресДляЗагрузки=DownloadURL
АдресИмениФайлаВыгрузки=ExportFileNameAddress
АдресИсправления=PatchAddress
АдресМенеджераСервиса=ServiceManagerURL
АдресныйКанал=TargetedChannel
АдресОбработки=DataProcessorAddress
АдресОписаниеИсправлений=AddressPatchesDetails
АдресПрограммногоИнтерфейса=APIAddress
АдресПубликацииСервисаУправления=ManagementServicePublicationURL
АдресРегистрации=RegistrationAddress
АдресФайла=FileAddress
АдресФайлаЗаявления=ApplicationFilePath
АдресЭлектроннойПочтыАбонента=SubscriberEmailAddress
Активный=Active
АнализЗапросаПроведен=QueryAnalysisPerformed
АналогиНомерСтроки=AnalogsRowNumber
АнимацияДлительнаяОперация=TimeConsumingOperationAnimation
БазаЗарегистрирована=BaseRegistered
БанкЗакрыт=BankClosed
БанкНепрямыхРасчетовЗакрыт=IntermediaryBankClosed
БанкНепрямыхРасчетовРаботает=IntermediaryBankOperates
БанковскиеСчета=BankAccounts
БанковскийСчетКонтрагента=CounterpartyBankAccount
БанковскийСчетКонтрагентаВалюта=CounterpartyBankAccountCurrency
БанкРаботает=BankOperates
БезЗависимостей=NoDependencies
БезЗависимостейИспользование=NoDependenciesUsage
БезЗависимостейКоличество=NoDependenciesCount
БезЗависимостейПрефикс=NoDependenciesPrefix
БезУдаленных=WithoutDeletedItems
БИКБанка1=BankBIC1
БИКБанкаДляРасчетов1=TransferBankBIC1
БИКБанкаДляРасчетовНачалоВыбора=SettlementBankBICStartChoice
БИКБанкаДляРасчетовОткрытие=SettlementBankBICOpening
БИКБанкаНачалоВыбора=BankBICStartChoice
БИКБанкаОткрытие=BankBICOpening
БудетВстроено=WillBeBuiltIn
Было=PreviousText
БыстрыйОтбор=QuickFilter
ВариантЗавершенияМиграции=MigrationCompletionOption
ВариантРасписания=ScheduleOption1_
ВариантСинхронизацииДокументов=DocumentsSynchronizationOption
ВариантСинхронизацииДокументовВручную=DocumentsSynchronizationOptionManually
ВариантСинхронизацииДокументовОписание1=DocumentsSynchronizationOptionDetails1
ВариантСинхронизацииДокументовОписание2=DocumentsSynchronizationOptionDetails2
ВариантСинхронизацииДокументовОписание3=DocumentsSynchronizationOptionDetails3
ВариантСинхронизацииДокументовОписание4=DocumentsSynchronizationOptionDetails4
ВариантСинхронизацииДокументовОтправлятьАвтоматически=DocumentsSynchronizationOptionSendAutomatically
ВариантСинхронизацииДокументовОтправлятьПолучатьАвтоматически=DocumentsSynchronizationOptionSendReceiveAutomatically
ВариантСинхронизацииДокументовПолучатьАвтоматически=DocumentsSynchronizationOptionReceiveAutomatically
ВариантСинхронизацииСправочников=CatalogsSynchronizationOption
ВариантСинхронизацииСправочниковАвтоматически=CatalogsSynchronizationOptionAutomatically
ВариантСинхронизацииСправочниковВручную=CatalogsSynchronizationOptionManually
ВариантСинхронизацииСправочниковОписание1=CatalogsSynchronizationOptionDetails1
ВариантСинхронизацииСправочниковОписание2=CatalogsSynchronizationOptionDetails2
ВариантСинхронизацииСправочниковОписание3=CatalogsSynchronizationOptionDetails3
ВариантСинхронизацииСправочниковТолькоИспользуемуюВДокументах=CatalogsSynchronizationOptionOnlyMasterDataUsedInDocuments
ВариантыЗагрузки=ImportOptions
ВариантыСинхронизации=SynchronizationOptions
ВариантыСинхронизацииДокументов=DocumentsSynchronizationOptions
ВариантыСинхронизацииДокументовГруппа=DocumentsSynchronizationOptionsGroup
ВариантыСинхронизацииСправочников=CatalogsSynchronizationOptions
ВариантыСинхронизацииСправочниковГруппа=CatalogsSynchronizationOptionsGroup
ВвестиДанныеДляУправления=EnterDataToManage
Версии=Versions
ВерсииОбластей=AreasVersions
ВерсииОбластейДанных=DataAreasVersions
ВерсииОбластейДанныхИзменены=DataAreasVersionsChanged
ВерсииОбщихДанных=CommonDataVersions
ВерсииОбщихДанныхИзменены=CommonDataVersionsChanged
ВерсияКалендарей=CalendarsVersion
ВерсияКомпоненты=VersionComponents
ВертикальнаяГруппа4=VerticalGroup4
ВертикальноеВыравнивание=VerticalAlignment
ВидГраницыФормы=FormBorderKind
ВидДокумента=DocumentKind
ВидКонтактнойИнформацииАдресаДоставки=DeliveryAddressContactInformationKind
ВидКонтактнойИнформацииЭлектроннойПочты=EmailContactInformationKind
ВидКонтрагентаПриИзменении=CounterpartyKindOnChange
ВидМетаданных=MetadataKind
ВидОрганизации=CompanyType
ВидОрганизацииИП=CompanyTypeIndividualEnterpreneur
ВидОрганизацииЮридическоеЛицо=CompanyTypeBusinessEntity
ВидОрганизацииЮридическоеЛицоПриИзменении=BusinessEntityCompanyKindOnChange
ВидОтображенияДанных=DataDisplayType
ВидПроблемы=IssueKind
ВидСтрокой=KindString
ВидСчета=AccountType
ВидыДокументов=DocumentsKinds
ВидыДокументовОтбор=DocumentsKindsFilter
ВидыДокументовПредставление=DocumentsKindsPresentation
ВидыОграниченийПрав=AccessRestrictionKinds
ВКлассификаторе=InClassifier
ВключитьВсеОрганизации=EnableAllCompanies
Вложение=Attachment
ВнешниеПользователиПереопределяемый=ExternalUsersOverridable
ВозможноРазвертывание=CanExpand
ВойтиВОбластьДанных=SignInToDataArea
ВойтиВУказаннуюОбластьДанных=SignInToSpecifiedDataArea
ВосстановитьЗапросыИзФайла=RecoverQueriesFromFile
ВременныйКаталог=TempDirectory
ВсегоФорм=TotalForms
ВсеКоманды=AllCommands
ВсеОграниченияДоступа=AllAccessRestrictions
ВставитьСтроки=InsertRows
ВтораяГруппа=SecondGroup
ВходныеДанныеВBase64=InputDataInBase64
ВходящиеСообщения=IncomingMessages1
ВыборОдногоОбъекта=SingleObjectSelection
ВыборРежимаОбновленияСерверныйРежим=UpdateModeSelectionServerMode
ВыборРежимаОбновленияФайловыйРежим=UpdateModeSelectionFileMode
ВыбранаПользователем=SelectedByUser
ВыбранныеИсправления=SelectedPatches
ВыбранныеИсправленияНоваяВерсия=SelectedCorrectionsNewVersion
ВыбранныеИсправленияТекущаяВерсия=SelectedCorrectionsCurrentVersion
ВыбратьЗапрос=Select_Query
ВыбратьЗапросыИзФайла=SelectQueriesFromFile
ВыбратьОтмеченные=SelectWithMark
ВывестиСписокПодсистем=OutputSubsystemsList
ВыводитьРезультатыЗапроса=OutputQueryResults
Выгружать=Export
ВыгружатьТекстыRLS=ExportRLSTexts
ВыгружатьФайлыВКаталог=ExportFilesToDirectory
ВыгрузитьДанные=ExportData
ВыгрузитьОписания=ExportDetails
ВыгрузитьСертификат=ExportCertificate
ВыгрузитьТаблицуЗначений=ExportValuesTable
ВыгрузкаНаКлиентеИлиНаСервере=ExportAtClientOrAtServer
ВыделитьВсеПроверки=SelectAllChecks
ВыделитьЯчейки=SelectCells
ВызватьОшибку=RaiseError
ВызватьОшибкуСейчас=RaiseErrorNow
ВызовыПлан=CallsPlanned
ВызовыФакт=CallsActual
ВыйтиИзОбластиДанных=SignOutOfDataArea
ВыйтиИзТекущейОбластиДанных=SignOutOfCurrentDataArea
ВыписатьСчетФактуру=PostTaxInvoice
ВыполнитьВыборРезультатаЗапроса=SelectQueryResult
ВыполнитьДействие=ExecuteAction
ВыполнитьЗамер=PerformMeasurement
ВыполнитьЗапрос=ExecuteQuery
ВыполнитьЗапросСВременнымиТаблицами=ExecuteQueryUsingTempTables
ВыполняетсяПроверка=CheckInProgress
ВыполнятьВыгрузкуВоВременнуюПапку=ExportToTemporaryFolder
ВыполнятьЧерезРегламентноеЗадание=ExecuteViaScheduledJob
ГиперссылкаПоказатьИнструкциюПоСозданиюФаксимильнойПодписиИПечати=HyperlinkShowManualOnCreatingReplicaSignatureAndSeal
ГоризонтальнаяГруппа6=HorizontalGroup6
Группа17=Group17
Группа18=Group18
Группа25=Group25
Группа29=Group29
Группа32=Group32
Группа64=Group64
Группа65=Group65
ГруппаАвтоматическаяУстановка=AutoInstallGroup
ГруппаАвтоматическимУдалениемОбъектов=AutoDeleteObjectsGroup
ГруппаАналоги=AnalogsGroup
ГруппаАутентификации=AuthenticationGroup
ГруппаАутентификацияОтступ=AuthenticationIndentGroup
ГруппаБанк=BankGroup1
ГруппаБанкДляНепрямыхРасчетов=IntermediaryBankGroup
ГруппаБанкДляРасчетов=SettlementBankGroup
ГруппаВарианта=VariantGroup
ГруппаВариантВыбораЗначений=GroupValueSelectionOption
ГруппаВводаПериода=PeriodInputGroup
ГруппаВерсионированиеОбъектов=ObjectVersioningGroup
ГруппаВзаимодействия=InteractionsGroup
ГруппаВидДокументаПечатнаяФорма=DocumentKindPrintFormGroup
ГруппаВидРасчета=CalculationTypeGroup
ГруппаВременноеХранилище=TemporaryStorageGroup
ГруппаВсеПоля=AllFieldsGroup
ГруппаВходВОбласть=SignInToDataAreaGroup
ГруппаВходящийНомерДата=IncomingNumberDateGroup
ГруппаВыбораОбъектов=ObjectsSelectionGroup
ГруппаВыбораОрганизаций=CompaniesSelectionGroup
ГруппаВыбораПодразделений=DivisionSelectionGroup
ГруппаВыбораСкладов=WarehouseSelectionGroup
ГруппаВыбораТипаБазы=InfobaseTypeSelectionGroup
ГруппаВыборКлассификаторов=ClassifiersSelectionGroup
ГруппаВыборРежимаОбновления=UpdateModeSelectionGroup
ГруппаВыборРежимаОбновленияСервер=GroupUpdateModeSelectionServer
ГруппаВыборРежимаОбновленияФайл=GroupSelectUpdateModeFile
ГруппаВыписатьСчетФактуру=PostTaxInvoiceGroup
ГруппаВыполнить=ExecuteGroup
ГруппаГород=CityGroup
ГруппаГражданствоИМестоРождения=GroupCitizenshipAndBirthplace
ГруппаДанныеОФизическомЛице=DataOnIndividualGroup
ГруппаДата=DateGroup
ГруппаДатаВерсия=DataVersionGroup
ГруппаДатаВид=DateKindGroup
ГруппаДатаЗапретаРедактированияДанных=PeriodEndClosingDateGroup
ГруппаДатаНомер=DateNumberGroup
ГруппаДатаПроцент=DatePercentageGroup
ГруппаДатаРожденияИПол=BirthDateAndGenderGroup
ГруппаДатыРабочихДней=WorkdaysDatesGroup
ГруппаДействияСДокументами=DocumentOperationsGroup
ГруппаДемоПереносСведенийОПользователяхВДругуюПрограммуОткрыть=DemoTransferUserInfoToAnotherProgramGroupOpen
ГруппаДлительнаяОперацияДекорации=TimeConsumingOperationDecorationsGroup
ГруппаДоговор=ContractGroup
ГруппаДокумент=GroupDocument
ГруппаДокументы=DocumentsGroup
ГруппаДополнительныеОбъекты=AdditionalObjectsGroup
ГруппаДополнительныеПоля=AdditionalFieldsGroup
ГруппаДополнительныеРеквизитыШапки=AdditionalAttributesHeaderGroup
ГруппаДоставка=DeliveryGroup
ГруппаДоступныеТестовыеПериоды=AvailableTrialPeriodsGroup
ГруппаЗаблокироватьОбъект=LockObjectGroup
ГруппаЗависимостьПодсистем=SubsystemsDependencyGroup
ГруппаЗаголовкаИКодаСтарогоНомера=OldPhoneNumberHeaderAndCodeGroup
ГруппаЗагрузка=GroupImport
ГруппаЗагрузкаДанных=GroupDataImport
ГруппаЗагрузкаДанныхИзФайловВСправочник=DataImportFromFilesToCatalogGroup
ГруппаЗапланированныйМоментЗапуска=ScheduledStartTimeGroup
ГруппаЗапроса=QueryGroup
ГруппаЗапросНеВыполнен=QueryNotExecutedGroup
ГруппаЗапускИЗавершениеРаботы=JobStartAndCompletionGroup
ГруппаЗарегистрировать=RegisterGroup
ГруппаЗащитаОтОпасныхДействий=ProtectionFromHarmfulActionsGroup
ГруппаИдентификаторОбмена=ExchangeIDGroup
ГруппаИзменитьНастройку=ChangeSettingGroup
ГруппаИндивидуальныйПредприниматель=IndividualEnterpreneurGroup
ГруппаИндикаторНеуспешноеИсправление=TroubleshootingFailedIndicatorGroup
ГруппаИНН=TINGroup
ГруппаИННКПП=TINCRTRGroup
ГруппаИнструкция=InstructionGroup_
ГруппаИнтервал=IntervalGroup
ГруппаИнфо=InfoGroup
ГруппаИнфОбнПрограммы=AppUpdateInfoGroup
ГруппаИнформационныхСсылок=InformationReferencesGroup
ГруппаИнформацияДатаЗапрета=PeriodEndClosingDateInformationGroup
ГруппаИнформацияНастройкаСоставаПолучаемыхДанных=InformationReceivedDataCompositionSettingsGroup
ГруппаИнформацияОСтоимостиЗапроса=QueryCostInformationGroup
ГруппаИнформацияПередЗагрузкой=InfoBeforeImportGroup
ГруппаИспользованиеВидовОграничений=UseRestrictionsKindsGroup
ГруппаИспользованиеВидовОграниченийОтступ=UseRestrictionsKindsIndentGroup
ГруппаИспользованиеВидовОграниченийСОтступом=UseRestrictionsKindsWithIndentGroup
ГруппаИспользоватьНесколькоОрганизаций=UseMultipleCompaniesGroup
ГруппаИсправления=CorrectionsGroup
ГруппаИсходныйЯзык=SourceLanguageGroup
ГруппаКалендарь=CalendarGroup
ГруппаКартинка=GroupPicture
ГруппаКаталогВыгрузки=GroupDumpDirectory
ГруппаКаталогНаКлиенте=DirectoryAtClientGroup
ГруппаКаталогНаСервере=DirectoryAtServerGroup
ГруппаКаталогРасширений=ExtensionsDirectoryGroup
ГруппаКаталогСохраненияКомпонентаПлатформы=DirectoryToSavePlatformComponentGroup
ГруппаКаталогСохраненияПлатформы=DirectoryToSavePlatformGroup
ГруппаКемИКогдаВыдан=IssuedByAndIssueDateGroup
ГруппаКнопкаДалее=NextButtonGroup
ГруппаКнопкаНазад=BackButtonGroup
ГруппаКнопкаОтмена=CancelButtonGroup
ГруппаКнопкиОтветаНаВопрос=GroupAnswerButtons
ГруппаКнопокПараметры=ButtonsGroupParameters
ГруппаКнопокСлева=LeftButtonsGroup
ГруппаКнопокСправа=RightButtonsGroup
ГруппаКод=CodeGroup
ГруппаКодИОтменаВводаНовогоТелефона=CodeAndNewPhoneNumberInputCancelationGroup
ГруппаКодИОтменаВводаТелефон=CodeAndPhoneNumberInputCancelationGroup
ГруппаКодИОтменаВводаЭлектроннаяПочта=CodeAndEmailInputCancelationGroup
ГруппаКодПодтверждения=ConfirmationCodeGroup
ГруппаКодПодтвержденияИТекстОшибкиСтарогоНомера=ConfirmationCodeAndErrorMessageTextForOldPhoneNumberGroup
ГруппаКодПодтвержденияТелефон=ConfirmationCodePhoneNumberGroup
ГруппаКодПодтвержденияЭлектроннаяПочта=ConfirmationCodeEmailGroup
ГруппаКодРодитель=ParentCodeGroup
ГруппаКодТелефона=PhoneCodeGroup
ГруппаКодТелефонаОсновное=PhoneCodeGroupMain
ГруппаКодТелефонаПояснение=PhoneCodeGroupNote
ГруппаКоды=CodesGroup
ГруппаКоличествоВалютаДт=QuantityCurrencyDrGroup
ГруппаКоличествоВалютаКт=QuantityCurrencyCrGroup
ГруппаКоличествоДней=DaysCountGroup
ГруппаКоманд=CommandGroup
ГруппаКомандаВыгрузки=GroupExportCommand
ГруппаКомандаЗагрузка=ImportCommandGroup
ГруппаКоманднаяПанельОтборВидДокумента=CommandBarFilterDocumentKindGroup
ГруппаКомандныеПанели=CommandBarsGroup
ГруппаКомандыОбработкаЗапросов=QueriesProcessingCommandsGroup
ГруппаКомандыПередЗагрузкой=CommandsBeforeImportGroup
ГруппаКомандыСтраницы=CommandsPagesGroup
ГруппаКомитент=ConsignorGroup
ГруппаКомментарийОтветственный=GroupCommentResponsible
ГруппаКомпоновки=CompositionGroup
ГруппаКонтактнаяИнформацияПоле_ДемоEmailКонтрагента=ContactInformationGroupField_DemoCounterpartyEmail
ГруппаКонтактнаяИнформацияПоле_ДемоSkypeКонтрагенты=ContactInformationGroupField_DemoSkypeCounterparties
ГруппаКонтактнаяИнформацияФизическогоЛица=IndividualContactInformationGroup
ГруппаКонтрагент=CounterpartyGroup
ГруппаКонфигурацияИзменена=ConfigurationModifiedGroup
ГруппаКПП=CRTRGroup
ГруппаКуда=DestinationGroup
ГруппаКудаСохранять=WhereToSaveGroup
ГруппаЛогин=UsernameGroup
ГруппаЛогинИПароль=UsernameAndPasswordGroup
ГруппаЛоготипКартинка=GroupLogoPicture
ГруппаМестаХранения=StorageLocationsGroup
ГруппаМесто=LocationGroup
ГруппаМестоВыгрузки=ExportLocationGroup
ГруппаМоиЗадачи=MyTasksGroup
ГруппаНазадСохранить=BackGroupSave
ГруппаНаименованиеИКод=DescriptionAndCodeGroup
ГруппаНаименованиеКод=DescriptionCodeGroup
ГруппаНастройкаДополнительныхОтборов=AdditionalFiltersSettingsGroup
ГруппаНастройкаЗавершена=SettingCompletedGroup
ГруппаНастройкаОтборовНаУзле=NodeFiltersSettingsGroup
ГруппаНастройкаОтправкиДокументов=DocumentsSendingSettingsGroup
ГруппаНастройкиВыгрузки=ExportSettingsGroup
ГруппаНастройкиЗагрузки=ImportSettingsGroup
ГруппаНастройкиЛеваяКолонка=SettingsGroupLeftColumn
ГруппаНастройкиОбмена=GroupExchangeSettings
ГруппаНастройкиОтправкиНСИ=MasterDataSendingSettingsGroup
ГруппаНастройкиПодключения=ConnectionSettingsGroup
ГруппаНастройкиПраваяКолонка=SettingsGroupRighColumn
ГруппаНастройкиРабочейДаты=WorkingDateSettingsGroup
ГруппаНастройкиЭлектроннойПодписиИШифрования=DigitalSignatureAndEncryptionSettingsGroup
ГруппаНеСинхронизироватьДокументы=NeverSynchronizeDocumentsGroup
ГруппаНоваяПочта=NewEmailGroup
ГруппаНовостей=NewsGroup
ГруппаНовыйТелефон=NewPhoneNumberGroup
ГруппаНовыйТелефонПолеСКартинкой=NewPhoneNumberFieldAndPictureGroup
ГруппаНоменклатураПоУмолчанию=DefaultProductsGroup
ГруппаНомерКартинка=NumberPictureGroup
ГруппаНомеров=NumbersGroup
ГруппаНомерТелефонаДляПроверки=PhoneNumberToConfirmGroup
ГруппаНСИ=MasterDataGroup
ГруппаОбновлениеКонфигурации=ConfigurationUpdateGroup
ГруппаОбновлениеПлатформы=PlatformUpdateGroup
ГруппаОбновлениеПодробно=UpdateDetailsGroup
ГруппаОбработкаЗапросов=QueriesProcessingGroup
ГруппаОбщая=GroupCommon
ГруппаОбщиеОтборы=CommonFiltersGroup
ГруппаОбщиеОтборыОбщая=CommonFiltersGroupCommon
ГруппаОбъектМетаданных=MetadataObjectGroup
ГруппаОбъектыВыгрузки=ExportObjectsGroup
ГруппаОднаДата=OneDateGroup
ГруппаОжиданиеОтветаПраваяКолонка=WaitingForResponseRightColumnGroup
ГруппаОписаниеПодсистем=SubsystemsDetailsGroup
ГруппаОповещения=NotificationGroup
ГруппаОрганизация=CompanyGroup
ГруппаОрганизацияФизическоеЛицо=GroupCompanyIndividual
ГруппаОсновнаяОрганизация=MainCompanyGroup
ГруппаОсновнаяПередЗагрузкой=MainBeforeImportGroup
ГруппаОсновныеДанные=MainDataGroup
ГруппаОсновныеДанныеФотография=GroupMainDataPhoto
ГруппаОтборВидыДокументов=FilterDocumentsKindsGroup
ГруппаОтборПоОрганизации=FilterByCompanyGroup
ГруппаОтборПоПодразделению=FilterByDepartmentGroup
ГруппаОтборПоСкладу=FilterByWarehouseGroup
ГруппаОткрытКонфигуратор=DesignerOpenedGroup
ГруппаОткуда=SourceGroup1
ГруппаОтображениеСчетаФактура=DisplayTaxInvoiceGroup
ГруппаОтсчет=CountdownGroup
ГруппаОшибкаТаймаут=TimeoutErrorGroup
ГруппаОшибкиОбновления=UpdateErrorsGroup
ГруппаОшибкиПроверкиПодключения=ConnectionCheckErrorsGroup
ГруппаОшибкиСозданияНастройки=SettingCreationErrorsGroup
ГруппаПанели=PanelsGroup
ГруппаПапкаВыгрузкиКонфигурации=ConfigurationExportFolderGroup
ГруппаПапкаВыгрузкиТекстов=TextsExportFolderGroup
ГруппаПараметрыВерсии=VersionParametersGroup
ГруппаПараметрыУстановкиКомпонентаПлатформа=PlatformComponentInstallationParametersGroup
ГруппаПараметрыУстановкиПлатформы=PlatformInstallationParametersGroup
ГруппаПарольИТекстОшибки=GroupPasswordAndErrorText
ГруппаПарольКартинкаИОтступНовогоТелефона=PasswordPictureAndNewPhoneNumberIndentGroup
ГруппаПарольКартинкаИОтступНовойПочты=PasswordPictureAndNewEmailIndentGroup
ГруппаПартнер=GroupPartner
ГруппаПартнерКонтрагент=PartnerCounterpartyGroup
ГруппаПаспортГражданинаРФ=RFCitizenPassportGroup
ГруппаПаспортГражданинаРФНомерСерияКемВыдан=RFCitizenPassportSeriesNumberIssuedByGroup
ГруппаПереключательИДатаНачала=RadioButtonsAndStartDateGroup
ГруппаПереносСведенийОПользователяхВДругуюПрограмму=TransferUserInfoToAnotherProgramGroup
ГруппаПериодВыгрузки=GroupExportPeriod
ГруппаПериодДействия=ValidityPeriodGroup
ГруппаПериодНомерСтроки=GroupPeriodRowNumber
ГруппаПланВыполненияЗапроса=QueryExecutionPlanGroup
ГруппаПланВыполненияЗапросаSQLСервер=QueryExecutionPlanGroupSQLServer
ГруппаПланВыполненияЗапросаТекстовоеПредставление=QueryExecutionPlanTextPresentationGroup
ГруппаПланЗапросаПанель=QueryPlanPanelGroup
ГруппаПоВсемОрганизациям=ForAllCompaniesGroup
ГруппаПоВсемПодразделениям=GroupForAllDivisions
ГруппаПоВсемСкладам=GroupForAllWarehouses
ГруппаПоВыбранным=ForSelectedCompaniesGroup
ГруппаПоВыбраннымОрганизациям=GroupBySelectedOrganizations
ГруппаПоВыбраннымПодразделениям=GroupBySelectedDivisions
ГруппаПоВыбраннымСкладам=GroupBySelectedWarehouses
ГруппаПодключение=ActivationGroup
ГруппаПодключениеКПорталу=ConnectionToPortalGroup
ГруппаПодключенТестовыйПериод=TrialPeriodActivatedGroup
ГруппаПодсистемы=SubsystemsGroup1
ГруппаПодтвержденияСтарогоНомера=OldPhoneNumberConfirmationGroup
ГруппаПоиска=SearchGroup1
ГруппаПоказыватьСоСкрытымиПДн=ShowWithHiddenPDGroup
ГруппаПолучениеПланаВыполненияЗапроса=GetQueryExecutionPlanGroup
ГруппаПользовательскихНастроекСписокРеализаций=UserSettingsGroupSalesList
ГруппаПорядокОплатыВалюта=CurrencyPaymentProcedureGroup
ГруппаПорядокРасчетовПоДоговору=ContractSettlementsProcedureGroup
ГруппаПояснениеОтозвано=GroupNoteRecalled
ГруппаПраваяПанель=RightBarGroup
ГруппаПредупреждения=WarningsGroup
ГруппаПримерыРасчета=CalculationExamplesGroup
ГруппаПроведеноБанком=PostedByBankGroup
ГруппаПроведенПометкаУдаления=PostedGroupDeletionMark
ГруппаПроверитьИсполнение=CheckCompletionGroup
ГруппаПродавец=SellerGroup
ГруппаПроекта=ProjectGroup
ГруппаПроектов=ProjectsGroup
ГруппаПрокси=ProxyGroup
ГруппаПростыеДубли=SimpleDuplicatesGroup
ГруппаПрочиеДействия=OtherOperationsGroup
ГруппаПрочиеНастройки=OtherSettingsGroup
ГруппаПунктЗона=PointGroupZone
ГруппаРабочаяДата=WorkingDateGroup
ГруппаРабочаяДатаОтступ=WorkingDateIndentGroup
ГруппаРасположениеБазы=InfobasePathGroup
ГруппаРассчитать=CalculateGroup
ГруппаРассчитатьМассивДат=CalculateDatesArrayGroup
ГруппаРассчитатьОднуДату=CalculateOneDateGroup
ГруппаРасчетДатыОкончания=EndDateCalculationGroup
ГруппаРасчетКоличестваДней=DaysCountCalculationGroup
ГруппаРасчетныйСчетИБанк=SettlementAccountAndBankGroup
ГруппаРасширениеНеУстановлено=ExtensionNotInstalledGroup
ГруппаРасширениеУстановлено=ExtensionInstalledGroup
ГруппаРегистратор=RecorderGroup
ГруппаРегистрыНакопления=AccumulationRegistersGroup
ГруппаРегистрыСведений=InformationRegistersGroup
ГруппаРегламентноеЗадание=ScheduledJobGroup
ГруппаРежимОтправкиДокументов=SendDocumentsModeGroup
ГруппаРежимОтправкиНСИ=MasterDataSendingModeGroup
ГруппаРезультатаЗапроса=QueryResultGroup
ГруппаРезультатЗапроса=GroupQueryResult
ГруппаРеквизиты=AttributesGroup
ГруппаРеквизитыОрганизации=CompanyDetailsGroup
ГруппаРодительИКод=ParentAndCodeGroup
ГруппаСерверная=ServerInfobaseGroup
ГруппаСерияНомер=SeriesNumberGroup
ГруппаСинхронизироватьДокументыАвтоматически=SynchronizeDocumentsAutomaticallyGroup
ГруппаСинхронизироватьДокументыВручную=SynchronizeDocumentsManuallyGroup
ГруппаСклад=WarehouseGroup_
ГруппаСлужебнаяИнформацияПрочее=InternalInformationOtherGroup
ГруппаСНИЛС_ИНН=GroupIIAN_TIN
ГруппаСодержаниеПароля=PasswordContentGroup
ГруппаСозданияИдеи=IdeaCreationGroup
ГруппаСозданияСообщенияВТехподдержку=CreateMessageToTechSupportGroup
ГруппаСообщениеДоступноОбновление=UpdateAvailableMessageGroup
ГруппаСостояниеВыполнения=ExecutionStateGroup
ГруппаСостояниеПодключения=ConnectionStatusGroup
ГруппаСпискиЗначенийВидовОграничений=RestrictionsKindsValuesListsGroup
ГруппаСпособПодключения=ConnectionMethodGroup
ГруппаСравнение=ComparisonGroup
ГруппаСсылки=GroupLinks
ГруппаСтавкаНДСПоУмолчанию=DefaultVATRateGroup
ГруппаСтандартныеРеквизиты=StandardAttributesGroup
ГруппаСтартовыхСтраниц=StartPagesGroup
ГруппаСтатистика=StatisticsGroup
ГруппаСтороныДоговора=ContractPartiesGroup
ГруппаСтраницаВыбираемыхВидовЦен=GroupPageOfSelectedPriceTypes
ГруппаСтраницаОтборПоОрганизациям=FilterByCompaniesPageGroup
ГруппаСтраницаОтборПоОрганизациямПустая=FilterByCompaniesBlankPageGroup
ГруппаСтраницаОтборПоПодразделениям=GroupPageSelectionByDivision
ГруппаСтраницаОтборПоПодразделениямПустая=GroupPageSelectionByDivisionIsEmpty
ГруппаСтраницаОтборПоСкладам=GroupPageSelectionByWarehouses
ГруппаСтраницаОтборПоСкладамПустая=GroupPageSelectionByWarehousesIsEmpty
ГруппаСтраницаПодборОрганизаций=GroupPageOrganizationSelection
ГруппаСтраницыДанных=DataPagesGroup
ГруппаСтраницыОтборПоОрганизациям=FilterByCompaniesPagesGroup
ГруппаСтраницыОтборПоПодразделениям=PageGroupSelectionByDivision
ГруппаСтраницыОтборПоСкладам=GroupOfPageSelectionByWarehouses
ГруппаСтрока=StringGroup
ГруппаСтрокиПоиска=SearchStringsGroup
ГруппаСубконтоВидРасчета=ExtDimensionCalculationTypeGroup
ГруппаСубконтоДт=ExtDimensionDrGroup
ГруппаСубконтоКт=ExtDimensionCrGroup
ГруппаСумма=AmountGroup
ГруппаСуммаОплаты=PayAmountGroup
ГруппаСуммаСодержание=AmountContentGroup
ГруппаСформированныйSQLТекстЗапроса=GeneratedSQLQueryTextGroup
ГруппаСЧемСравнивать=CompareToWhatGroup
ГруппаСчета=GroupOfAccount
ГруппаСчетДт=GroupAccount_3Dr
ГруппаСчетКт=GroupAccount_3Cr
ГруппаСчетФактура=TaxInvoiceGroup
ГруппаТабличныеЧасти=TabularSectionsGroup
ГруппаТекстЗапроса=QueryTextGroup
ГруппаТекстПредупреждения=WarningTextGroup
ГруппаТелефон=PhoneGroup
ГруппаТест=TestGroup
ГруппаТип=TypeGroup
ГруппаТипБазы=InfobaseTypeGroup
ГруппаТипИсполнителя=PerformerTypeGroup
ГруппаТипПроверяющего=SupervisorTypeGroup
ГруппаТовары=GroupGoods
ГруппаУведомлятьОбИзменениеСтатусаЗаказа=NotifyOnOrderStatusChangeGroup
ГруппаУстановитьОбновлениеИзФайла=InstallUpdateFromFileGroup
ГруппаУточнениеВыгрузки=ExportClarificationGroup
ГруппаФайловая=FileInfobaseGroup
ГруппаФлаговИспользованияОтборов=FiltersUsageFlagsGroup
ГруппаФорума=ForumGroup
ГруппаФотография=PhotographGroup
ГруппаЦентрМониторингаСерверныйРежим=GroupMonitoringCenterServerMode
ГруппаЦентрМониторингаФайловыйРежим=GroupMonitoringCenterFileMode
ГруппаШаг1=GroupStep1
ГруппаШаг2=GroupStep2
ГруппаШаг3=GroupStep3
ГруппаШаг6=GroupStep6
ГруппаШаг7=GroupStep7
ГруппаШапкаДоговора=ContractHeaderGroup
ГруппаШтрихкод=BarcodeGroup
ГруппаЭлектроннаяПочтаПолеСКартинкой=EmailFieldAndPictureGroup
ГруппаЭлектроннойПочты=EmailGroup
ГруппаЭтапы=StagesGroup
ГруппаЯзыкПеревода=TranslationLanguageGroup
ДанныеАвторизации=AuthorizationData
ДанныеДляУправления=DataToManage
ДанныеКлассификаторов=ClassifiersData
ДанныеПодключения=ActivationData
ДанныеПодсистемыБазоваяФункциональность=CoreSubsystemData
ДанныеПодсистемыВариантыОтчетов=ReportOptionsSubsystemData
ДанныеПодсистемыИнформацияПриЗапуске=InformationOnStartSubsystemData
ДанныеПодсистемыКонтрольВеденияУчета=AccountingAuditSubsystemData
ДанныеПодсистемыПользователи=UsersSubsystemData
ДанныеПодсистемыУправлениеДоступом=AccessManagementSubsystemData
ДанныеПроизводственныхКалендарейСтраница=BusinessCalendarsDataPage
ДатаВремяОбновленияУстановлена=UpdateDateTimeSet
ДатаДоговора_КонтекстноеМеню=ContractDate_ContextMenu
ДатаЗавершения1=CompletedOn1
ДатаНачала1=StartDate1
ДатаНачалаДействия_КонтекстноеМеню=ValidityStartDateContextMenu
ДатаНомер=DateNumber
ДатаНомер1=DateNumber1
ДатаОкончанияДействия_КонтекстноеМеню=ValidityEndDateContextMenu
ДатаПоКалендарю=DateByCalendar
ДатыРабочихДней=WorkdaysDates
Движения_ДемоОстаткиТоваровВМестахХранения=RegisterRecords_DemoAvailableStockInStorageLocations
Движения_ДемоОстаткиТоваровВМестахХраненияВидДвижения=RegisterRecords_DemoAvailableStockInStorageLocationsRegisterRecordKind
Движения_ДемоОстаткиТоваровВМестахХраненияКоличество=RegisterRecords_DemoAvailableStockInStorageLocationsQuantity
Движения_ДемоОстаткиТоваровВМестахХраненияМестоХранения=RegisterRecords_DemoAvailableStockInStorageLocationsStorageLocation
Движения_ДемоОстаткиТоваровВМестахХраненияНоменклатура=RegisterRecords_DemoAvailableStockInStorageLocationsProducts
Движения_ДемоОстаткиТоваровВМестахХраненияНомерСтроки=RegisterRecords_DemoAvailableStockInStorageLocationsRowNumber
Движения_ДемоОстаткиТоваровВМестахХраненияОрганизация=RegisterRecords_DemoAvailableStockInStorageLocationsCompany
Движения_ДемоОстаткиТоваровВМестахХраненияПериод=RegisterRecords_DemoAvailableStockInStorageLocationsPeriod
ДействиеПоДвойномуЩелчкуМыши=ActionOnDoubleClick
ДействиеСКонстантой=OperationWithConstant
ДействиеСформировать=ActionGenerate
ДействиеСформироватьШтрихкод=ActionGenerateBarcode
ДекорациОписание=DecorationsDetails
Декорация1КонтекстноеМеню1=Decoration1ContextMenu1
Декорация1РасширеннаяПодсказка1=Decoration1ExtendedTooltip1
Декорация25=Decoration25
Декорация35=Decoration35
Декорация36=Decoration36
Декорация37=Decoration37
ДекорацияАдресСервисаКартинка=ServiceAddressDecorationPicture
ДекорацияВариантЗавершенияМиграции=MigrationCompletionOptionDecoration
ДекорацияВключенияПланаЗапроса=QueryPlanActivationDecoration
ДекорацияВнимание=AttentionDecoration
ДекорацияВопросПередЗагрузкой=QuestionBeforeImportDecoration
ДекорацияВосстановление=RecoveryDecoration
ДекорацияВсеИдентификаторы=DecorationAllIDs
ДекорацияДва=DecorationTwo
ДекорацияДлительнаяОперацияКартинка=DecorationTimeConsumingOperationPicture
ДекорацияЗавершениеОбмена=DecorationExchangeCompletion
ДекорацияЗаголовокОбновлениеКонфигурации=ConfigurationUpdateHeaderDecoration
ДекорацияЗаголовокОбновлениеПлатформы=PlatformUpdateHeaderDecoration
ДекорацияЗаголовокПатчи=DecorationHeaderPatches
ДекорацияЗагрузитьДистрибутивКомпонентаПлатформы=DownloadPlatformComponentDistributionPackageDecoration
ДекорацияЗагрузитьДистрибутивКомпонентаПлатформыОбработкаНавигационнойСсылки=ImportPlatformComponentDistributionPackageDecorationURLProcessing
ДекорацияЗагрузитьДистрибутивПлатформы=DownloadPlatformDistributionPackageDecoration
ДекорацияЗагрузкаИсправленийРасписание=CorrectionsImportDecorationSchedule
ДекорацияЗапретРедактирования=CannotEditDecoration
ДекорацияЗапросНеВыполнен=QueryNotExecutedDecoration
ДекорацияЗарегистрироватьсяНаПортале1СИТС=RegisterAt1CITSPortalDecoration
ДекорацияИдентификационныеДанные=IDDataDecoration
ДекорацияИнструкцияУстановкаЗавершенаОбработкаНавигационнойСсылки=InstallationCompleteInstructionDecorationURLProcessing
ДекорацияИнформацияОбОшибке=ErrorInformationDecoration
ДекорацияИнформацияУстановкаЗавершена=InstallationCompleteInformationDecoration
ДекорацияКартинка2=PictureDecoration2
ДекорацияКартинка33=PictureDecoration33
ДекорацияКартинка36=PictureDecoration36
ДекорацияКартинка4=PictureDecoration4
ДекорацияКартинка5=PictureDecoration5
ДекорацияКартинка6=PictureDecoration6
ДекорацияКартинка8=PictureDecoration8
ДекорацияКартинкаИнформацияДатыЗапрета=PeriodEndClosingDateInformationPictureDecoration
ДекорацияКартинкаИнформацияНастройкаСоставаПолучаемыхДанных=InformationReceivedDataCompositionSettingsPictureDecoration
ДекорацияКартинкаРегЗадание=DecorationPictureScheduledJob
ДекорацияКартинкаРезультат=PictureResultDecoration
ДекорацияКартинкаСостояниеПодключения=DecorationPictureConnectionStatus
ДекорацияЛегенда=DecorationLegend
ДекорацияЛогин=UsernameDecoration
ДекорацияНадпись=LabelDecoration
ДекорацияНадписьИнформацияДатыЗапрета=PeriodEndClosingDateInformationLabelDecoration
ДекорацияНадписьИнформацияНастройкаСоставаПолучаемыхДанных=InformationReceivedDataCompositionSettingsLabelDecoration
ДекорацияНадписьПодключен=ActivatedLabelDecoration
ДекорацияНадписьПустаяОтборПоОрганизациям=FilterByCompaniesBlankLabelDecoration
ДекорацияНадписьПустаяОтборПоПодразделениям=DecorationInscriptionIsEmptySelectionByDivision
ДекорацияНадписьПустаяОтборПоПодразделениям1=DecorationInscriptionIsEmptySelectionByDivision1
ДекорацияНадписьСостояниеПодключения=DecorationLabelConnectionStatus
ДекорацияНаписатьВТехПоддержку=EmailTechSupportDecoration
ДекорацияНастройкаЗавершенаКартинка=DecorationSettingCompletedPicture
ДекорацияНачало=StartDecoration
ДекорацияНетВерсии=NoVersionDecoration
ДекорацияНомерВерсииКонфигурации=ConfigurationVersionNumberDecoration
ДекорацияНомерВерсииПлатформы=PlatformVersionNumberDecoration
ДекорацияОбработкаЗапросовЗаголовок=QueriesProcessingHeaderDecoration
ДекорацияОбработкаЗапросовПиктограмма=QueriesProcessingIconDecoration
ДекорацияОбъектовВыгруженоЗагружено=ObjectsExportedImportedDecoration
ДекорацияОдин=DecorationOne
ДекорацияОжиданиеБублик=WaitingCircleDecoration
ДекорацияОжиданиеКартинка=WaitingPictureDecoration
ДекорацияОжиданиеНадпись=WaitLabelDecoration1
ДекорацияОжиданиеОтветаДлительнаяОперация=WaitingForResponseTimeConsumingOperationDecoration
ДекорацияОкончание=EndDecoration
ДекорацияОписаниеМиграции=MigrationDetailsDecoration
ДекорацияОписаниеРезультата=ResultDetailsDecoration
ДекорацияОсталосьВыгрузитьЗагрузить=LeftToExportImportDecoration
ДекорацияОткрытьЖурналРегистрации=OpenEventLogDecoration
ДекорацияОтступГруппыДокументов=DocumentsGroupIndentDecoration
ДекорацияОтступОтборПоОрганизации=IndentFilterByCompanyDecoration
ДекорацияОтступОтборПоПодразделениям=DecorationSelectionByDivision
ДекорацияОтступОтборПоСкладам=DecorationSelectionByWarehouses
ДекорацияОшибкаКартинка=DecorationErrorPicture
ДекорацияОшибкаНадпись=DecorationErrorLabel
ДекорацияОшибкаПодключения=ConnectionFailureDecoration
ДекорацияОшибкаТаймаут=TimeoutErrorDecoration
ДекорацияПароль=PasswordDecoration
ДекорацияПатчиВерсияКонфигурации=DecorationPatchesConfigurationVersion
ДекорацияПатчиИсправляемыеОшибки=DecorationPatchesErrorsBeingCorrected
ДекорацияПерейти=DecorationTransit
ДекорацияПовторитьКод=RepeatCodeDecoration
ДекорацияПодготавливаетсяФайлВыгрузки=PreparingExportFileDecoration
ДекорацияПодключенТестовыйПериод=TrialPeriodActivatedDecoration
ДекорацияПодпись=ExplatationDecoration
ДекорацияПодписьОшибкаТаймаут=TimeoutErrorLabelDecoration
ДекорацияПолучатель=RecipientDecoration
ДекорацияПолучениеДистрибутива=GetDistributionPackageDecoration
ДекорацияПояснениеОтозвано=DecorationNoteRecalled
ДекорацияПояснениеПлатформа=PlatformNoteDecoration
ДекорацияПояснениеПлатформаКлиентСервер=PlatformNoteDecorationClientServer
ДекорацияПраваПользователей=UsersRightsDecoration
ДекорацияПредупреждение1=WarningDecoration1
ДекорацияПредупреждение2=WarningDecoration2
ДекорацияПредупреждения=DecorationWarnings
ДекорацияПримерЗагрузкиИзФайла=ImportFromFileExampleDecoration
ДекорацияПродолжение=DecorationContinued
ДекорацияПятнадцать=DecorationFifteen
ДекорацияПять=DecorationFive
ДекорацияРасписаниеЗадания=DecorationJobSchedule
ДекорацияРегистрация=RegistrationDecoration
ДекорацияРекомендацииПриОшибке=ErrorFixingRecommendationsDecoration
ДекорацияСдвиг=IndentDecoration2
ДекорацияСкопируйтеИдентификатор=DecorationCopyID
ДекорацияСлужебнаяИнформацияДляПримера=ServiceInformationExampleDecoration
ДекорацияСообщение=MessageDecoration
ДекорацияСообщениеДоступноОбновление=UpdateAvailableMessageDecoration
ДекорацияСообщениеНоваяВерсияПлатформы=NewPlatformVersionMessageDecoration
ДекорацияСообщениеОбОшибкеПолученияОбновления=UpdateAcquisitionErrorMessageDecoration
ДекорацияСообщениеПлатформаУжеУстановлена=PlatformAlreadyInstalledMessageDecoration
ДекорацияСообщениеСервиса=ServiceMessageDecoration
ДекорацияСообщенийОтправленоОбработано=MessagesSentProcessedDecoration
ДекорацияСсылка=DecorationRef
ДекорацияСтатусСопоставления=MappingStatusDecoration
ДекорацияТелефон=PhoneDecoration
ДекорацияТипыФайлов=FilesTypesDecoration
ДекорацияТри=DecorationThree
ДекорацияУстановитьОбновлениеИзФайла=InstallUpdateFromFileDecoration
ДекорацияУстановитьОбновлениеИзФайлаПодсказка=InstallUpdateFromFileDecorationTooltip
ДекорацияУточнение=ClarificationDecoration
ДекорацияЧетыре=DecorationFour
ДекорацияЧетырнадцать=DecorationFourteen
ДекорацияШаг1=Step1Decoration
ДекорацияШаг2=Step2Decoration
ДекорацияШаг3=Step3Decoration
ДемонстрацияВторогоВарианта=OptionTwoDemo
ДемонстрацияПервогоВарианта=OptionOneDemo
ДемонстрацияТретьегоВарианта=OptionThreeDemo
ДемонстрацияЧетвертогоВарианта=OptionFourDemo
ДеревоВызовыПлан=CallsPlanTree
ДеревоВызовыФакт=CallsFactTree
ДеревоЗагрузкаЦП=CPULoadTree
ДеревоЗатратыВводаВывода=InputOutputExpensesTree
ДеревоКод=CodeTree
ДеревоКод_КонтекстноеМеню=CodeTreeContextMenu
ДеревоНаименование=TreeDescription
ДеревоНаименование_КонтекстноеМеню=DescriptionTreeContextMenu
ДеревоОбъектов=ObjectsTree
ДеревоОбъектовГруппаДействия=ObjectTreeOperationsGroup
ДеревоОбъектовСнятьПометку=ObjectsTreeClearMark
ДеревоОбъектовУстановитьПометку=ObjectsTreeSetMark
ДеревоОператор=OperatorTree
ДеревоОператорМетаданные=OperatorTreeMetadata
ДеревоОтступ=IndentTree
ДеревоПланаВыполненияЗапроса=QueryExecutionPlanTree
ДеревоПланаВыполненияЗапросаГруппаВызовы=QueryExecutionPlanTreeCallsGroup
ДеревоПланаВыполненияЗапросаГруппаСтоимость=QueryExecutionPlanTreeGroupCost
ДеревоПланаВыполненияЗапросаСтроки=QueryExecutionPlanTreeLines
ДеревоПриАктивизацииСтроки=TreeOnActivateRow
ДеревоСреднийРазмерСтрок=AverageLineLengthTree
ДеревоСсылка=CodeTreeRef
ДеревоСтоимость=CostTree
ДеревоСтоимостьСтоимостьОбщая=CostTreeTotalCost
ДеревоСтрокиПлан=LinesPlanTree
ДеревоСтрокиФакт=LinesFactTree
ДеятельностьБанкаНепрямыхРасчетовПрекращена=IntermediaryBankOperationsDiscontinued
ДляВнешнихПользователейОшибки=ForExternalUsersErrors
ДляНовойВерсии=ForNewVersion
ДляПользователей=ForUsers
ДляПользователейОшибки=ForUsersErrors
ДобавитьВРезультатВыгрузки=AddToExportResult
ДобавитьЗапросыИзФайла=AddQueriesFromFile
ДобавитьИзЗапроса=AddFromQuery
ДобавитьОшибкуПриОтложенномОбновлении=AddErrorOnDeferredUpdate
ДобавитьПользователяСервиса=AddServiceUser
ДобавитьПрефиксКНаименованию=AddPrefixToDescription
ДокументДатаВыдачи=IdentityDocumentIssuedOn
ДокументКемВыдан=DocumentIssuedBy
ДокументКодПодразделения=DocumentDepartmentCode
ДокументНомер=DocumentNumber
ДокументОтпускаСотрудников=EmployeesLeavesDocument
ДокументСерия=DocumentSeries
ДокументТекстЗапроса=QueryTextDocument
Дополнительное=Additional
ДополнительноСлева=AdvancedLeft
ДополнительноСправа=AdvancedRight
ДополнительныеОбъектыДляВыгрузкиГруппа1=AdditionalObjectsToExportGroup1
ДоступнаОтправкаСообщенийТехПоддержке=SendMessagesToTechnicalSupportAvailable
ДоступноПодключениеКСистемеВзаимодействияВМоделиСервиса=CanConnectToCollaborationSystemSaaS
ДругойСпособ=OtherMethod
ЕстьГруппы=HasGroups
ЕстьПравоДоступаКБухфону=HasAccessRightTo1CConnect
ЖурналДокументовВзаимодействияНастройкиРаботыСПочтой=InteractionDocumentsJournalEmailOperationSettings
Заблокирован=IsLocked
ЗаблокированныеРеквизиты=LockedAttributes
ЗаблокироватьДокумент=LockDocument_
ЗаблокироватьОбъект=LockObject
ЗаблокироватьПользователя=LockUser
ЗависимостиПрав=RightsDependencies
ЗависимыеПодсистемы=DependentSubsystems
ЗависитОтПодсистем=DependsOnSubsystems
ЗаголовокДиалога=DialogTitle
ЗаголовокДоступноОбновление=UpdateAvailableHeader
ЗаголовокНетОбновления=NoUpdateHeader
ЗаголовокНоваяПочта=NewEmailHeader
ЗаголовокНовыйТелефон=NewPhoneNumberHeader
ЗаголовокОкна=WindowTitle
ЗаголовокСсылкиДействия=HeaderReferencesActions
ЗаголовокСтарогоНомера=OldPhoneNumberHeader
ЗагружатьИнформациюОПользователях=ImportUsersDetails
ЗагружатьИнформацияОПользователях=ImportUsersDetails1
ЗагрузитьВариантыОтчетов=LoadReportOptions
ЗагрузитьВнешнийМодульИзФайла=ImportExternalModuleFromFile
ЗагрузитьВнешнийМодульИзФайлаСДополнительнойИнформацией=ImportExternalModuleFromFileWithAdditionalInformation
ЗагрузитьДанные=ImportData
ЗагрузитьКартинку=UploadPicture
ЗагрузитьОбъектов=ImportObjects
ЗагрузитьСертификат=ImportCertificate
ЗагрузитьТоварыИзФайла=ImportGoodsFromFile
ЗагрузитьФайл=ImportFile_
ЗагрузкаЗавершена=ImportCompleted
ЗагрузкаНаКлиентеИлиНаСервере=ImportAtClientOrAtServer
ЗагрузкаСПолучениемДополнительнойИнформации=ImportAndGetAdditionalInformation
ЗагрузкаЦП=CPUUtilization
ЗадатьУникальныйИдентификатор=SetUUID
ЗадачаСсылка=TaskRef
ЗаказЗакрыт=OrderClosed
ЗаказПроведен=OrderPosted
Закомментировать=CommentOut
ЗаменитьВоВсехМестахИспользования=ReplaceAllInstances
ЗаменитьИУдалить=ReplaceAndDelete
ЗаписанныйВидНоменклатуры=RecordedProductKind
ЗаписатьВсе=WriteAll
ЗаписатьГраницу=WriteBorder
ЗаписатьЗакрыть=WriteClose
ЗаполнитьИзXML=FillFromXML
ЗаполнитьКалендари=FillCalendars
ЗаполнитьПараметры=FillParameters_
ЗапрашиватьПодтверждениеПриЗавершенииПрограммы=AskConfirmationOnExit
ЗапроситьСписокПроектов=GetProjectsList
ЗапроситьСписокПроектовСейчас=GetProjectsListNow
ЗапросыID=QueriesID
ЗапросыВосстановитьЗапросыИзФайла=QueriesRecoverQueriesFromFile
ЗапросыВыбратьЗапрос=QueriesSelectQuery
ЗапросыНаПредоставлениеДоступа=RequestsToGrantAccess
ЗапросыСохранитьЗапросыВДругойФайл=QueriesSaveQueriesToAnotherFile
ЗапросыСохранитьЗапросыВФайл=QueriesSaveQueriesToFile
ЗапускОтложенногоОбновления=StartDeferredUpdate
ЗапуститьИЗавершить=RunAndEnd
ЗапуститьКонфигуратор=RunDesigner
ЗапуститьОбновлениеИнформационнойБазы=StartInfobaseUpdate
ЗапуститьРегламентноеЗадание=RunScheduledJob
Зарегистрировать=Register
ЗарплатаНомерСтроки=SalaryRowNumber
ЗатратыВводаВывода=InputOutputCosts
ЗаявлениеНаСертификат=CertificateApplication
ЗаявлениеОтправлено=ApplicationSent
ЗначениеВФорме=ValueInForm
ЗначениеВФормеКонтекстноеМенюУстановитьИД=ValueInFormContextMenuSetID
ЗначениеДолговременного=LongTermTokenName
ЗначениеЗаголовкаIfModifiedSince=HeaderValueIfModifiedSince
ЗначениеПараметра=ParameterValue
ЗначениеРабочейДаты=WorkingDateValue
ЗначокКаталогРасширений=ExtensionsDirectoryIcon
ЗначокОбсудитьНаФоруме=SearchForumIcon
ЗначокОтправкиВТехПоддержку=SendToTechSupportIcon
ЗначокПодачиИдеи=IdeaSuggestionIcon
ИдентификаторВерсия=IDVersion
ИдентификаторЗаявления=ApplicationID
ИдентификаторИнтернетСервиса=InternetServiceID
ИдентификаторОбмена=ExchangeID
ИдентификаторПользователяСистемыВзаимодействия=CollaborationSystemUserID
ИдентификаторПриложения1=AppID1
ИдентификаторПриложения2=AppID2
ИдентификаторПроцессаОС=OSProcessID
ИдентификаторРедактируемогоПриложения1=ApplicationToEditID1
ИдентификаторРедактируемогоПриложения2=ApplicationToEditID2
ИдентификаторСистемы=SystemID
ИдентификаторТарифа=SupportPlanID
ИдентификаторТекущегоЗапроса=CurrentQueryID
ИдентификаторТекущегоПараметра=CurrentParameterID
ИДФоновогоЗадания=BackgroundJobID
ИерархияПодсистем=SubsystemsHierarchy
ИзмененЛогинПароль=UsernamePasswordChanged
ИзменитьПолучателя=ChangeRecipient
ИменаПредопределенныхЗначений=PredefinedValuesNames
ИмитироватьОшибкуПриОбновлении=SimuateErrorOnUpdate
ИмитироватьОшибкуПриОтложенномОбновлении=SimuateErrorOnDeferredUpdate
ИмитироватьОшибкуПриОтложенномПараллельномОбновлении=SimuateErrorOnDeferredParallelUpdate
ИмяЗапроса=QueryName1
ИмяЗапросаПоУмолчанию=DefaultQueryName
ИмяНовойПрограммы=NewApplicationName
ИмяОбластиЯчейки=CellAreaName
ИмяОбъектаОбработки=DataProcessorObjectName
ИмяОткрываемойФормы=NameOfFormToOpen_
ИмяПроекта=ProjectName
ИмяРодителя=ParentName
ИмяСПиктограммой=NameWithIcon
ИмяТабличнойЧасти=TabularSectionName
ИмяТипа=TypeName
ИмяФайлаЗагрузки=ImportFileName
ИмяФайлаИлиАдрес=FileNameOrAddress
ИмяФайлаНаКлиенте=FileNameAtClient
ИмяФайлаОбработки=DataProcessorFileName
ИмяЭлементаДляРазмещения=ItemForPlacementName
ИмяЭлементаФормы=FormItemName
ИндексПоискаОтчетов=ReportSearchIndex
ИндикаторДлительнойОперации2=TimeConsumingOperationIndicator2
ИндикаторОбновления=UpdateIndicator
ИнструкцияРедактированияВерсий=VersionsEditingManual
Инструменты=Tools
ИнтернетСервис=InternetService
ИнформационнаяНадписьОтбор=HelpTextFilter
ИнформационнаяНадписьОчиститьИндекс=HelpTextClearIndex
ИнформационныеСсылки=InformationReferences
ИнформацияОВнешнемМодуле=ExternalModuleInformation
ИнформацияОДоступномОбновлении=AvailableUpdateInformation
ИнформацияОКомпоненте=AddInInformation
Исключаемый=IsExcludable
ИсполнительПоНазначению=PerformerByAssignment
ИсполнительСтрокой=PerformerString
ИспользоватьНесколькоОрганизаций=UseMultipleCompanies
ИспользоватьНСтр=UseNStr
ИспользоватьПериодОтбора=UseFilterPeriod
ИспользоватьПодключаемоеОборудование=UsePeripherals
ИспользоватьТекущуюДатуКомпьютера=UseCurrentDeviceDate
ИспользоватьТокен=UseToken
ИспользоватьХарактеристики=UseCharacteristics
ИспользуетсяБанкДляРасчетов=SettlementBankUsed
ИспользуетсяИнтеграцияССистемойВзаимодействияВМоделиСервиса=IntegrationWithCollaborationSystemUsedSaaS
ИсправленияГруппаКолонкиВертикальнаяГруппировка=CorrectionsGroupColumnsVerticalGroup
ИсточникОграничений=RestrictionsSource
ИсточникСравнения=ComparisonSource
ИсходныйТекст=SourceText
ИтогиИАгрегатыСброситьДаты=TotalsAndAggregatesClearDates
КакРаботатьИнфо=UsageHelpInfo
КартинкаBase64=PictureBase64
КартинкаЕстьРасширения=ExtensionsAvailablePicture
КартинкаПояснениеОтозвано=PictureNoteRecalled
КартинкаПрисутствияПриложения=ApplicationPresencePicture
КартинкаСервиса=ServicePicture
КартинкаТелефонПроверен=PhoneNumberConfirmedPicture
КартинкаЭлектроннаяПочтаПроверена=EmailConfirmedPicture
КассаПолучатель=CashAccountRecipient
КаталогВыгрузкиКонфигурацииВФайлыНачалоВыбора=DirectoryOfConfigurationExportToFilesStartChoice
КаталогВыгрузкиКонфигурацииВФайлыОткрытие=DirectoryOfConfigurationExportToFilesOpen
КаталогВыгрузкиКонфигурацииВФайлыПриИзменении=DirectoryOfConfigurationExportToFilesOnChange
КаталогСЛогФайлами=LogFilesDirectory
КаталогСохраненияДистрибутиваКомпонентаПлатформы=DirectoryToSavePlatformComponentDistributionPackage
КаталогСохраненияДистрибутиваПлатформы=DirectoryToSavePlatformDistributionPackage
КаталогСохраненияНачалоВыбора=SavingDirectoryStartChoice
КаталогСохраненияПлатформы=DirectoryToSavePlatform
КаталогУстановкиПлатформы=PlatformInstallationDirectory
КаталогФайловойБазы=InfobaseFolder
КлассификаторБанковКорреспондентовРФ=CorrespondentBankClassifier
Классификаторы=Classifiers
КлючСопоставления=MatchingKey
КнопкаВыбрать=SelectButton
КнопкаСправка=HelpButton
Код1С=OneCCode
КодАбонента=SubscriberCode
КодПодтвержденияТелефон=ConfirmationCodePhoneNumber
КодПодтвержденияТелефонСтарый=ConfirmationCodeOldPhoneNumber
КодПодтвержденияЭлектроннаяПочта=ConfirmationCodeEmail
КодПриложения=ApplicationCode
КодТелефона=PhoneCode
КодУправления=ControlCode
КодыБанка=BankCodes
КодыБанкаЗарубежногоСчета=BankCodesForeignAccount
КодыБанкаРасчетов=SettlementBankCodes
КодыБанкаРасчетовВалютногоСчета=SettlementBankCodesForCurrencyAccount
КодыБанкаРасчетовРублевогоСчета=SettlementBankCodesForAccountInRubles
КодыБанкаРоссийскогоСчета=BankCodesRussianAccount
КодыИСостоянияБанка=BankCodesAndStatuses
КодыИСостоянияБанкаДляРасчетов=SettlementBankCodesAndStatuses
КоличествоДокументов=DocumentsCount
КоличествоЗаказов=OrdersCount
КоличествоПорций=BatchesCount
КоличествоСтрокGS1Databar=GS1DatabarRowsCount
КоличествоЦена=AmountPrice
КолонкаСтатистики1=StatisticsColumn1
КолонкаСтатистики2=StatisticsColumn2
КолонкаСтатистики3=StatisticsColumn3
КомандаВыполнить=CommandExecute
КомандаКонтактнаяИнформацияПоле_ДемоEmailКонтрагента=CommandContactInformationField_DemoCounterpartyEmail
КомандаКонтактнаяИнформацияПоле_ДемоSkypeКонтрагенты=CommandContactInformationField_DemoSkypeCounterparties
КомандаПроверить=CheckCommand
КомандаСохранить=SaveCommand
КомандаСформироватьИПрофиль=GenerateCommandAndProfile
КоманднаяПанельГлавное=CommandBarMain
КоманднаяПанельДополнительно=CommandBarAdditional
КоманднаяПанельМножественныйВыбор=CommandBarMultipleChoice
КоманднаяПанельСписокРеализаций=CommandBarSalesList
КоманднаяПанельТовары=GoodsCommandBar
КомандыОжиданиеОтвета=WaitingForResponseCommands
КомандыСотрудники=TeamsEmployees
КомандыУстановкиСостояний=StatesSettingCommands
КомментарийАдресаДоставки=DeliveryAddressComment
КомментарийИОтветственный=CommendAndEmployeeResponsible
КомментарийОтветственный=CommentEmployeeResponsible
Компания=Company
КонкретныйПрофиль=SpecificProfile
КонтактнаяИнформацияПоле_ДемоEmailКонтрагента=ContactInformationField_DemoCounterpartyEmail
КонтактнаяИнформацияПоле_ДемоSkypeКонтрагенты=ContactInformationField_DemoSkypeCounterparties
КонтактнаяИнформацияПоле_ДемоАдресКонтрагента=ContactInformationField_DemoCounterpartyAddress
КонтекстОбновления=UpdateContext
КонтрагентИНН=CounterpartyTIN
КонтрагентОрганизация=CounterpartyCompany
КонтрольИзмененияТекстовRLS=RLSTextModificationControl
КонтрольИзмененияТекстовRLSКоманднаяПанель=RLSTextModificationControlCommandBar
КонтрольИзмененияТекстовRLSОписание=RLSTextModificationControlDetails
КудаСохранять=WhereToSave
КудаСохранять1=WhereToSave1
КудаСохранять2=WhereToSave2
КудаСохранятьПриИзменении=WhereToSaveOnChange
ЛинейнаяЗависимость=LinearDependency
ЛинейнаяЗависимостьДлина=LinearDependencyLength
ЛинейнаяЗависимостьИспользование=LinearDependencyUsage
ЛинейнаяЗависимостьКоличество=LinearDependencyCount
ЛинейнаяЗависимостьПрефикс=LinearDependencyPrefix
ЛичныеДанные=PersonalData
Логин1=Username21
ЛогинРедактировался=UsernameEdited
ЛоготипКартинка=LogoImage
ЛоготипРазмерПроцентОтШК=LogoSizePercentFromBarcode
Локализуемый=ToLocalize
МакетДанныеПроизводственныхКалендарей=BusinessCalendarsDataTemplate
МакетПериодыНерабочихДней=NonWorkDaysPeriodsTemplate
МакетПроизводственныеКалендари=BusinessCalendarsTemplate
МакетыСтраницы=TemplatesPages
МгновенныеСообщения=InstantMessages
МестаХранения=StorageLocations_
МестоОбнаружения=DetectionLocation
МестоОткрытия=AccountOpeningLocation
МестоХраненияОрганизация=StorageLocationCompany
МестоХраненияОтветственный=StorageLocationEmployeeResponsible
МестоХраненияОтветственный1=StorageLocationEmployeeResponsible1
МестоХраненияОтветственныйКомментарий=StorageLocationEmployeeResponsibleComment
МеткаЗапроса=QueryMark
МетодыНомерСтроки=MethodsRowNumber
мИмяОбластиШапки=mHeaderAreaName
мИмяПредопределенныхДанных=mPredefinedDataName
мИмяПредопределенныхДанныхКолонка=mPredefinedDataNameColumn
МожноЗакрытьФормуСФайлами=CanCloseFormWithFiles
МОЛ_КонтекстноеМеню=ICContextMenu
МонопольноеОбновление=ExclusiveUpdate
НадписьВерсия=VersionLabel
НадписьВерсияУстановлено=VersionInstalledLabel
НадписьВосстановленияПароляАвторизация=PasswordRecoveryLabelAuthorization
НадписьДеятельностьБанкаРасчетовПрекращена=SettlementBankOperationsDiscontinuedLabel
НадписьДлительнаяОперация1=LabelTimeConsumingOperation1
НадписьЕстьНеПримененныеИсправления=LabelHasUnappliedCorrections
НадписьЕстьОшибкиУчета=LabelHasAccountingErrors
НадписьНетЛогинаИПароляАвторизация=NoUsernameAndPasswordAuthorizationLabel
НадписьНеуспешноеИсправление=TroubleshootingFailedLabel
НадписьОбратногоОтсчета=CountdownLabel
НадписьОбратногоОтсчетаТелефон=CountdownLabelPhoneNumber
НадписьОбратногоОтсчетаТелефонСтарый=CountdownLabelOldPhoneNumber
НадписьОбратногоОтсчетаЭлектроннаяПочта=CountdownLabelEmail
НадписьОсобенностиПерехода=TransitionSpecificsLabel
НадписьОсобенностиПереходаОбработкаНавигационнойСсылки=MigrationFeaturesLabelURLProcessing
НадписьПорядокОбновленияСервер=UpdateOrderServerLabel
НадписьПорядокОбновленияФайл=UpdateOrderFileLabel
НадписьПояснениеВыбораКлассификатора=ClassifierSelectionNoteLabel
НадписьПоясненияПодключенияАвторизация=ActivationAuthorizationNotesLabel
НадписьПроверкаПароля=PasswordCheckLabel
НадписьРазмерОбновления=UpdateSizeLabel
НадписьСведенияОПользователе=UserInfoLabel
НадписьУстановленоДополнительно=InstalledAdditionallyLabel
НадписьШаг1=TheWritingStep1
НадписьШаг1ОбработкаНавигационнойСсылки=Step1LabelURLProcessing
НадписьШаг2=TheWritingStep2
НадписьШаг3=TheWritingStep3
НадписьШаг4=TheWritingStep4
НадписьШаг5=TheWritingStep5
НадписьШаг6=TheWritingStep6
НадписьШаг7=TheWritingStep7
НазначениеИнфо=PurposeInfo
НаименованиеВладелец=OwnerDescription
НаименованиеИГородБанка=BankDescriptionAndCity
НаименованиеИГородБанкаДляРасчетов=SettlementBankDescriptionAndCity
НаименованиеКолонки=ColumnDescription
НаименованиеНастройки=SettingDescription
НаименованиеРедактировалось=DescriptionEdited
НаименованиеСистемы=SystemDescription
НаименованиеТарифа=SupportPlanDescription
НаименованиеТекущегоВарианта=CurrentVariantDescription
НайденныеРазличия=DifferencesFound
НайденныеРазличияЗначение=DifferencesFoundValue
НайтиОтветНаВопрос=FindAnswerToQuestion
НаписатьПисьмо=WriteEmail1
НаписатьЭлектронноеПисьмо=WriteEmail2
НапоминатьОбУстановкеРасширенияРаботыСФайлами=RemindAboutFileSystemExtensionInstallation
НастроитьДополнительно=ConfigureAdditionally
НастроитьПодтверждение=ConfigureConfirmation
НастройкаОграниченияМиграцииДанных=DataMigrationRestrictionSettings
НастройкаПроксиДоступСКлиента=ProxySettingsAccessFromClient
НастройкаПроксиДоступССервера=ProxySettingsAccessFromServer
НастройкаФильтровРегистрации=RegistrationFiltersSetup
НастройкиВнедрения=ImplementationSettings
НастройкиВыполнения=ExecutionSettings
НастройкиОбменаДаннымиОбновить=DataExchangeSettingsRefresh
НастройкиОткрытияФайлов=OpenFileSettings
НастройкиСоединенияССерверами=ServersConnectionSettings
НастройкиТаблицыЗначений=ValuesTableSettings
НастройкиТаблицыЗначенийВыгрузитьТаблицуЗначений=ValuesTableSettingsExportValuesTable
НастройкиТелефона=PhoneSettings
НациональнаяВалюта=NationalCurrency
НачальноеЗаполнениеПрофилей=InitialProfilesFilling
НачальноеЗначениеСпособаПодтвержденияКриптооперации=InitialValueOfCryptoOperationConfirmationMethod
НачальноеОписаниеНастройки=InitialSettingDescription
НерабочиеПериоды=NonWorkPeriods
НеРешаемаяКольцеваяЗависимость=UnsolvableCircularDependency
НеРешаемаяКольцеваяЗависимостьДлина=UnsolvableCircularDependencyLength
НеРешаемаяКольцеваяЗависимостьИспользование=UnsolvableCircularDependencyUsage
НеРешаемаяКольцеваяЗависимостьКоличество=UnsolvableCircularDependencyCount
НеРешаемаяКольцеваяЗависимостьПрефикс=UnsolvableCircularDependencyPrefix
НеРешаемаяКольцеваяЗависимостьРазрешаемаяПрефикс=UnsolvableCircularDependencyAllowedPrefix
НеУказано=NotSpecified1
НовыйТелефон=NewPhone
НоменклатураПоУмолчаниюОписание=DefaultProductsDetails
НоменклатураХарактеристика=ProductsCharacteristic
НоменклатураХарактеристикаКоличествоЦена=ProductsCharacteristicAmountPrice
НомераСеансов=SessionsNumbers
НомерДата=NumberDate
НомерДоговора_КонтекстноеМеню=ContractNumber_ContextMenu
НомерНовойРедакции=NewEditionNumber
НомерСчетаИВалюта=AccountNumberAndCurrency
ОбнаруженыЗамеры=MeasurementsFound
ОбнаруженыЗамерыПериод=MeasurementsFoundPeriod
ОбновитьДополнительныеОтчетыИОбработки=UpdateAdditionalReportsAndDataProcessors
ОбновитьДоступ=UpdateAccess
ОбновитьИнтерфейс=RefreshInterface
ОбновитьИнформацию=UpdateInformation2
ОбновитьКонфигурацию=UpdateConfiguration
ОбновитьНаИсправительнуюВерсию=UpdateToCorrectiveVersion
ОбновитьНеразделенныеДанные=UpdateSharedData
ОбновитьПлатформу=UpdatePlatform
ОбновитьПользователей=UpdateUsers
ОбновитьРазделенныеДанные=UpdateSeparatedData
ОбновлятьАвтоматический=UpdateAutomatically
Обработка_ДемоПереносСведенийОПользователяхВДругуюПрограммуОткрыть=DataProcessor_DemoTransferUserInfoToAnotherProgramOpen
Обработка_ЗагрузкаДанныхИзФайловВСправочник=DataProcessor_DataImportFromFilesToCatalog
ОбработчикПереходаСТекущегоШага=TransitionFromCurrentStepHandler
ОбратныйАдрес=ReplyTo
ОбращенияВПоддержкуНажатие=SupportRequestsClick
ОбслуживающаяОрганизацияТелефон=ServiceCompanyPhoneNumber
ОбслуживающаяОрганизацияЭлектроннаяПочта=ServiceCompanyEmail
ОбщаяКоманда_ДемоДокументацияПоВнедрениюИИспользованию=CommonCommand_DemoDeploymentAndOperationDocumentation
ОбщаяКоманда_ДемоСтандартыРазработки=CommonCommand_DemoDevelopmentStandards
ОбщаяКоманда_ДемоСтраницаПродуктаНаСайте1С=CommonCommand_DemoProductPageOn1CWebsite
ОбщаяКомандаЗапустить1СБухфонРасширеннаяПодсказка=CommonCommandRun1CConnectExtendedTooltip
ОбщаяКомандаЗапуститьОнлайнПоддержку=CommonCommandRunOnlineSupport
ОбщаяКомандаНастройкаОнлайнПоддержки=ConfigureOnlineSupportCommonCommand
ОбщееСообщение=CommonMessage
ОбщиеЯзыковыеПараметры=CommonLanguageParameters
ОбъединитьВыделенные=MergeSelectedItems
ОбъектМетаданныхСФайлами=MetadataObjectWithFiles
ОбъектОснование=BasisObject
ОбъектСсылка=ObjectRef
ОбъектыМетаданныхПредставление=MetadataObjectsPresentation
ОбъектыНазначенияЗначение=TargetObjectsValue
ОбычныеСообщения=OrdinaryMessages
Обязательная=Required
ОграничениеВРоли=RestrictionInRole
ОграничениеВРолиДляВнешнихПользователей=RestrictionInRoleForExternalUsers
ОграничениеВРолиЗаголовки=RestrictionInRoleHeaders
ОграничениеВРолиЗаголовкиДляВнешнихПользователей=RestrictionInRoleHeadersForExternalUsers
ОграничениеВРолиЗаголовокБезРасчета=RestrictionInRoleHeaderWithoutCalculation
ОграничениеВРолиЗаголовокБезРасчетаДляВнешнихПользователей=RestrictionInRoleHeaderWithoutCalculationForExternalUsers
ОграничениеВРолиЗаголовокБезРасчетаНадпись=RestrictionInRoleHeaderWithoutCalculationLabel
ОграничениеВРолиЗаголовокБезРасчетаНадписьДляВнешнихПользователей=RestrictionInRoleHeaderWithoutCalculationLabelForExternalUsers
ОграничениеВРолиЗаголовокСРасчетом=RestrictionInRoleHeaderWithCalculation
ОграничениеВРолиЗаголовокСРасчетомДляВнешнихПользователей=RestrictionInRoleHeaderWithCalculationForExternalUsers
ОграничениеВРолиЗаголовокСРасчетомЗаголовокСКнопкой=RestrictionInRoleHeaderWithCalculationHeaderWithButton
ОграничениеВРолиЗаголовокСРасчетомНадпись=RestrictionInRoleHeaderWithCalculationLabel
ОграничениеВРолиЗаголовокСРасчетомНадписьДляВнешнихПользователей=RestrictionInRoleHeaderWithCalculationLabelForExternalUsers
ОграничениеДоступа=AccessRestriction
ОграничениеПоВладельцу=RestrictionByOwner
ОграничениеПоВладельцуБезОптимизации=RestrictionByOwnerWithoutOptimization
ОграничениеПоВладельцуБезОптимизацииДляВнешнихПользователей=RestrictionByOwnerWithoutOptimizationForExternalUsers
ОграничениеПоВладельцуБезОптимизацииКартинка=RestrictionByOwnerWithoutOptimizationPicture
ОграничениеПоВладельцуБезОптимизацииКартинкаДляВнешнихПользователей=RestrictionByOwnerWithoutOptimizationPictureForExternalUsers
ОграничениеПоВладельцуБезОптимизацииНадпись=RestrictionByOwnerWithoutOptimizationLabel
ОграничениеПоВладельцуБезОптимизацииНадписьДляВнешнихПользователей=RestrictionByOwnerWithoutOptimizationLabelForExternalUsers
ОграничениеПоВладельцуБезОптимизацииОтступ=RestrictionByOwnerWithoutOptimizationIndent
ОграничениеПоВладельцуБезОптимизацииОтступДляВнешнихПользователей=RestrictionByOwnerWithoutOptimizationIndentForExternalUsers
ОграничениеПоВладельцуВозможно=RestrictionByOwnerPossible
ОграничениеПоВладельцуДляВнешнихПользователей=RestrictionByOwnerForExternalUsers
ОграничениеПоВладельцуНеРассчитано=RestrictionByOwnerNotCalculated
ОграничениеПоВладельцуНеРассчитаноДляВнешнихПользователей=RestrictionByOwnerNotCalculatedForExternalUsers
ОграничениеПоВладельцуНеРассчитаноОтступ=RestrictionByOwnerNotCalculatedIndent
ОграничениеПоВладельцуНеРассчитаноОтступДляВнешнихПользователей=RestrictionByOwnerNotCalculatedIndentForExternalUsers
ОграничениеПоВладельцуСОптимизацией=RestrictionByOwnerWithOptimization
ОграничениеПоВладельцуСОптимизациейДляВнешнихПользователей=RestrictionByOwnerWithOptimizationForExternalUsers
ОграничениеПоВладельцуСОптимизациейКартинка=RestrictionByOwnerWithOptimizationPicture
ОграничениеПоВладельцуСОптимизациейКартинкаДляВнешнихПользователей=RestrictionByOwnerWithOptimizationPictureForExternalUsers
ОграничениеПоВладельцуСОптимизациейНадпись=RestrictionByOwnerWithOptimizationLabel
ОграничениеПоВладельцуСОптимизациейНадписьДляВнешнихПользователей=RestrictionByOwnerWithOptimizationLabelForExternalUsers
ОграничениеПоВладельцуСОптимизациейОтступ=RestrictionByOwnerWithOptimizationIndent
ОграничениеПоВладельцуСОптимизациейОтступДляВнешнихПользователей=RestrictionByOwnerWithOptimizationIndentForExternalUsers
ОграниченияИзВыгрузки=RestrictionsFromExport
ОграниченияИзСписка=RestrictionsFromList
ОграниченияОтправкиДанных=DataSendingRestrictions
ОграниченияОтправкиДанныхПояснение=DataSendingRestrictionsNote
ОжидаемыйРезультат=ExpectedResult
ОператорМетаданные=OperatorMetadata
ОперацияПрервана=OperationAborted
ОписаниеВозможныхПравДляНастройкиПравОбъектов=AvailableRightsForObjectsRightSettingsDetails
ОписаниеДокументыНеОтправлять=DocumentDetailsDontSend
ОписаниеЗамера=MeasurementDetails
ОписаниеНастройки=SettingDetails
ОписаниеНеОтправлятьНСИ=DetailsNeverSendMasterData
ОписаниеОператора=OperatorDetails
ОписаниеОператораSQLServer=OperatorDetailsSQLServer
ОписаниеОтображаемое=DescriptionDisplayed
ОписаниеОтправлятьДанныеПоЗапросу=DetailsSendDataUponRequest
ОписаниеОтправлятьДокументыАвтоматически=DetailsSendDocumentsAutomatically
ОписаниеОтправлятьНСИАвтоматически=DetailsSendMasterDataAutomatically
ОписаниеОтправлятьНСИПоНеобходимости=DetailsSendMasterDataAsNecessary
ОписаниеПодсистемы=SubsystemDetails
ОписаниеПоставляемыхПрофилейГруппДоступа=SuppliedAccessGroupProfilesDescription
ОписаниеСервиса=ServiceDetails
ОписаниеСистемы=SystemDetails
ОписаниеТарифа=SupportPlanDetails
ОписаниеФайловОбновлений=UpdateFilesDetails
ОписаниеФормы=FormDetails
ОповещениеОтображено=NotificationDisplayed
ОповещениеПользователю=NotificationToTheUser
ОрганизацииВывестиСписок=CompaniesOutputList
ОрганизацииГруппа2=CompaniesGroup2
ОрганизацииДляОтображения=CompaniesToDisplay
ОрганизацииКопироватьВБуферОбмена=CompaniesCopyToClipboard
ОрганизацииНайти=CompaniesFind
ОрганизацииНомерСтроки=CompaniesRowNumber
ОрганизацииОтменитьПоиск=CompaniesCancelSearch
ОрганизацияКонтрагент=CompanyCounterparty
ОрганизацияМестоХранения=CompanyStorageLocation
ОрганизацияОтбор=CompanyFilter
ОрганизацияОтветственный=CompanyEmployeeResponsible
ОсновнаяОрганизация=MainCompany
ОсновнойПроект=MainProject
ОсталосьВремени=TimeLeft
ОтборАвторИзменения=FilterChangeAuthor
ОтборВидыДокументов=FilterDocumentsKinds
ОтборВидыДокументовОК=AllTypesOfDocumentsOK
ОтборОрганизация=FilterOrganization
ОтборПользователи=FilterUsers
ОтборПоСтатусуЗаказа=FilterByOrderStatus
ОтборРегистратор=FilterRecorder
ОтборСостояние=FilterState
ОтборСостоянияОригинала=FilterOriginalStates
ОтборСчет=FilterAccount
ОтборФизическоеЛицо=FilterIndividual
ОтветДа=ReplyYes
ОтветНет=ReplyNo
ОтветственныеЛицаОрганизаций=PersonsResponsibleAndCompanies
ОтветственныйКомментарий=EmployeeResponsibleComment
ОтветственныйСумма=EmployeeResponsibleSum
ОтключенныеПодсистемы=DisabledSubsystems
ОтключенныеПодсистемыГруппаКолонок=DisabledSubsystemsColumnsGroup
ОтключитьВсеОрганизации=DisableAllCompanies
ОтключитьОбратныйОтсчет=DisableCountdown
ОткрытьВОтдельномОкнеТабличныйДокумент=OpenSpreadsheetDocumentInNewWindow
ОткрытьДокумент=OpenDocument
ОткрытьДокументКоманда=OpenDocumentCommand
ОткрытьКонструкторЗапроса=OpenQueryBuilder
ОткрытьКонфигуратор=OpenDesigner
ОткрытьОбъектИзРезультата=OpenObjectFromResult
ОткрытьПрошлыеРезультатыПроверки=OpenPreviousCheckResults
ОткрытьРасписаниеЗадания=OpenJobSchedule
ОткрытьРезультатыПроверки=OpenCheckResults
ОткрытьСписокВыбранныхОрганизаций=OpenSelectedCompaniesList
ОткрытьСписокВыбранныхПодразделений=OpenListOfSelectedDivisions
ОткрытьСписокВыбранныхСкладов=OpenListOfSelectedWarehouses
ОткрытьСписокИзРезультата=OpenListFromResult
ОткрытьСписокПредупреждений=OpenWarningsList
ОткрытьСписокСчетовФактур=OpenTaxInvoicesList
ОткрытьФормуАктивныхПользователей=OpenActiveUsersForm
ОткрытьФормуВыбораЗапроса=OpenQuerySelectionForm
ОткрытьФормуЗапускаОтложенногоОбновления=OpenDeferredUpdateStartForm
ОткрытьФормуНастроекАвтоСохранения=OpenAutoSaveSettingsForm
ОтменаВводПароля=CancelPasswordInput
ОтменаЗагрузки=CancelImport
ОтменаОжидание=CancelWait
ОтменаОшибка=CancelError
ОтменитьИзменениеПочты=CancelEmailChange
ОтменитьИзменениеТелефона=CancelPhoneNumberChange
ОтменитьПроверкуТелефона=CancelPhoneNumberConfirmation
ОтменитьРегистрацию=CancelRegistration
Отметка=Mark
Отношения=Relationships
ОтображатьТабличныеЧасти=DisplayTabularSections
ОтображатьТекст=TextVisible
ОтображениеСписка=ListDisplay
ОтобразитьРезультат=DisplayResult
Отозвано=Revoked1
ОтпечатокСертификата=CertificateThumbprint
ОтправитьЗаявление=SendApplication
ОтправитьКодПовторно=ResendCode
ОтправитьКодПовторноТелефон=ResendCodePhoneNumber
ОтправитьКодПовторноТелефонСтарый=ResendCodeOldPhoneNumber
ОтправитьКодПовторноЭлектроннаяПочта=ResendCodeEmail
ОтправитьПарольПовторно=ResendPassword
ОтправитьСообщениеПодписчикам=SendMessageToSubscribers
ОтправитьСообщениеПолучателям=SendMessageToRecipients
ОтправлятьЗаголовокIfModifiedSince=SendHeaderIfModifiedSince
Отсрочка=Delay1
ОтступДоПримеров=IndentBeforeExamples
ОтступКоманднойПанели=CommandBarIndent
ОтступМежду=IndentBetween
ОтступНовогоТелефона=NewPhoneNumberIndent
ОтступНовойПочты=NewEmailIndent
ОтступПосле=IndentAfter
ОтчетыКонфигурации=ConfigurationReports
ОтчетыРасширений=ExtensionReports
ОчиститьДополнительныеОбъектыВыгрузки=ClearAdditionalObjectsToExport
ОчиститьРезультаты=ClearResults
ОшибкаСостояние=ErrorState
ПакетныйЗапуск=BatchRun
ПанелиФормыГруппа=FormPanelsGroup
ПанельДалее=PanelNext
ПанельДекорации=DecorationPanel
ПанельНазад=PanelBack
ПанельОшибкаПодключения=ConnectionFailurePanel
ПапкаLinux=LinuxFolder
ПапкаLinuxWeb=LinuxFolderWeb
ПапкаWindows=WindowsFolder
ПапкаWindowsWeb=WindowsFolderWeb
ПапкаВыгрузкиТекстовRLSИзЭтойКонфигурации=FolderForRLSTextExportFromThisConfiguration
ПапкаГотовойВыгрузкиКонфигурацииВФайлы=ReadyConfigurationFileDumpFolder
ПапкаПредыдущейВыгрузкиТекстовRLS=FolderForPreviousRLSTextExport
ПапкаСВыгруженнымиФайламиКонфигурации=FolderWithDumpedConfigurationFiles
ПапкиУстановленныхКомпонент=InstalledAddInsFolders
ПараметрыВыбратьЗапросыИзФайла=ParametersSelectQueriesFromFile
ПараметрыВыполненияВФоне=BackgroundExecutionParameters
ПараметрыГруппа=ParametersGroup1
ПараметрыДоступа=AccessParameters
ПараметрыЗамера=MeasurementParameters
ПараметрыЗапроса=QueryOptions
ПараметрыКонтактнойИнформации=ContactInformationParameters
ПараметрыМетода=MethodParameters
ПараметрыОбработчикаОжиданияСохраненияНастроек=SettingsSavingIdleHandlerParameters
ПараметрыОбработчикаСохраненияНастроек=SettingsSavingHandlerParameters
ПараметрыОткрытия=OpeningParameters
ПараметрыРаботыСФайлами=FilesOperationsParameters
ПараметрыСкопироватьЗапрос=ParametersCopyQuery
ПараметрыСохранитьЗапросыВДругойФайл=ParametersSaveQueryToAnotherFile
ПараметрыСохранитьЗапросыВФайл=ParametersSaveQueryToFile
ПараметрыСчитатьПараметрыИзТекстаЗапроса=ParametersReadParametersFromQueryText
ПараметрыШтрихкода=BarcodeParameters
Пароль1=Password1
ПарольНачалоВыбора=PasswordStartChoice
ПарольОтправлен=PasswordSent
ПарольОтправляется=PasswordBeingSent
ПарольПроверен=PasswordVerified
ПарольПроверяется=PasswordBeingChecked
ПартнерОрганизация=PartnerCompany
ПартнерыИКонтактныеЛицаГруппаКонтактнаяИнформация=PartnersAndContactPersonsContactInformationGroup
ПартнерыИКонтактныеЛицаНомерСтроки=PartnersAndContactPersonsRowNumber
Пассивный=Passive
ПерваяГруппа=FirstGroup
ПередачаСведенийВЦентрМониторинга=InformationTransferToMonitoringCenter
ПередачаСведенийВЦентрМониторингаСерверныйРежим=InformationTransferToMonitoringCenterServerMode
ПередачаСведенийВЦентрМониторингаФайловыйРежим=InformationTransferToMonitoringCenterFileMode
ПерезапускПрограммы=ApplicationRestart
ПерейтиКПомеченнымНаУдаление=GoToMarkedForDeletionItems
ПерейтиКСвязямПриложений=GoToApplicationsLinks
ПерейтиКСпискуПользователей=GoToUsersList
ПерейтиНазад=GoBack
ПерейтиНазад1=GoBack1
ПерейтиНазад2=GoBack2
ПерейтиНаСтраницуРегистрации=GoToRegistrationPage
ПерейтиНаСтраницуСопоставленияПользователей=GoToUsersMappingPage
ПереключательДокументыНеОтправлять=DoNotSendDocumentsRadioButton
ПереключательДокументыОтправлятьАвтоматически=SendDocumentsAutomaticallyRadioButtons
ПереключательДокументыОтправлятьВручную=SendDocumentsManuallyRadioButtons
ПереключательОтбораСправочниковБезОтбораПриИзменении=CatalogsFilterRadioButtonsWithoutFilterOnChange
ПереключательОтбораСправочниковСОтборомПриИзменении=CatalogSelectionSwitchWithSelectionOnChange
ПереключательОтправлятьНСИАвтоматически=SendMasterDataAutomaticallyRadioButtons
ПереключательОтправлятьНСИНикогда=NeverSendMasterDataRadioButtons
ПереключательОтправлятьНСИПоНеобходимости=SendMasterDataAsNecessaryRadioButtons
ПереключательПоВсемОрганизациям=ForAllCompaniesRadioButtons
ПереключательПоВсемПодразделениям=SwitchForAllDivisions
ПереключательПоВсемСкладам=SwitchForAllWarehouses
ПереключательПоВыбранным=ForSelectedCompaniesRadioButtons
ПереключательПоВыбраннымОрганизациям=SwitchBySelectedOrganizations
ПереключательПоВыбраннымПодразделениям=SwitchBySelectedDivisions
ПереключательПоВыбраннымСкладам=SwitchForSelectedWarehouses
ПереключитьАктивностьДвижений=SwitchRecordsActivity
ПереключитьАктивностьПроводок=SwitchPostingActivity
Перенести=MoveTo_
ПеренестиЗамеры=TransferMeasurements
ПеренестиЗамерыПериод=TransferMeasurementsPeriod
ПересчитатьВыгружаемыеПоСсылке=RecalculateDataToExportByRef
Переходы=Transitions
ПериодКонец=PeriodEnd_
ПериодНачало=PeriodBeginning
ПериодОтбора=FilterPeriod1
ПериодРегистрацииГод=RegistrationPeriodYear
ПериодРегистрацииМесяц=RegistrationPeriodMonth
ПериодРегистрацииСторно=ReversingEntryRegistrationPeriod
ПериодыНерабочихДнейСтраница=NonWorkDaysPeriodsPage
ПланВыполненияЗапросаВМетаданных=QueryExecutionPlanInMetadata
ПланВыполненияЗапросаИзТехЖурнала=QueryExecutionPlanFromTechLog
ПланВыполненияЗапросаТекст=QueryExecutionPlanText
ПланВыполненияЗапросаТекстовоеПредставление=QueryExecutionPlanTextPresentation
ПланЗапросаАктуален=QueryPlanUpToDate
ПланОбмена_ДемоОбменСБиблиотекойСтандартныхПодсистем=ExchangePlan_DemoExchangeWithStandardSubsystemsLibrary
ПовторитьКод=RepeatCode
ПовторитьОтправку=SendAgain
Подбор=Pickup
ПоддерживаемыеТипыПодключаемогоОборудования=SupportedPeripheralTypes
ПоддерживаетсяРегистрацияСистемыВзаимодействияНаСервере=CollaborationSystemRegistrationSupportedAtServer
Подключаемый_КонтактнаяИнформацияАвтоПодбор=Attachable_ContactInformationAutoComplete
Подключаемый_КонтактнаяИнформацияВыполнитьКоманду=Attachable_ContactInformationExecuteCommand
Подключаемый_КонтактнаяИнформацияНачалоВыбора=Attachable_ContactInformationStartChoice
Подключаемый_КонтактнаяИнформацияОбработкаВыбора=Attachable_ContactInformationChoiceProcessing
Подключаемый_КонтактнаяИнформацияОчистка=Attachable_ContactInformationClearing
Подключаемый_КонтактнаяИнформацияПриИзменении=Attachable_ContactInformationOnChange
Подключаемый_ТабличныйДокументНачалоВводаЗначения=Attachable_SpreadsheetDocumentValueInputStart
Подключаемый_ТабличныйДокументПриАктивизацииОбласти=Attachable_SpreadsheetDocumentOnActivateArea
Подключаемый_ТабличныйДокументПриИзменении=Attachable_SpreadsheetDocumentOnChange
ПодключениеВнешнихКомпонент=AddInsAttachment
Подключить=Connect
ПодключитьКомпоненту=AttachAddInSSL
ПодключитьКомпонентуCOM=AttachCOMComponent
ПодключитьКомпонентуБезКэширования=AttachAddInWithoutCaching
ПодключитьКомпонентуИзМакета=AttachAddInFromTemplate
ПодключитьКомпонентуИзМакетаНаСервере=AttachAddInFromTemplateAtServer
ПодключитьКомпонентуИзРеестраWindows=AttachAddInFromWindowsRegistry
ПодключитьКомпонентуНаСервере=AttachAddInSSLAtServer
ПодменюЗаполнить=FillSubmenu
ПодменюЗаполнитьВажное=SubmenuFillImportant
ПодменюЗаполнитьОбычное=SubmenuFillNormal
ПодменюЗаполнитьСмТакже=SubmenuFillSeeAlso
ПодменюПечатьВажное=SubmenuPrintImportant
ПодменюПечатьОбычное=SubmenuPrintNormal
ПодменюПечатьСмТакже=SubmenuPrintSeeAlso
ПодписиИПечати=SignaturesAndSeals
ПодразделенияНомерСтроки=DepartmentsRowNumber
ПодсистемаБазоваяФункциональность=CoreSubsystem
ПодсистемаВариантыОтчетов=ReportOptionsSubsystem
ПодсистемаИнформацияПриЗапуске=InformationOnStartSubsystem
ПодсистемаКонтрольВеденияУчета=AccountingAuditSubsystem
ПодсистемаПользователи=UsersSubsystem
ПодсистемаУправлениеДоступом=AccessManagementSubsystem
Подсистемы=Subsystems
ПодсистемыВывестиСписокПодсистем=SubsystemsOutputSubsystemsList
ПодсистемыОтметитьВсе=SubsystemsSelectAll
ПодсистемыПодсистемыОтметитьВсе=SubsystemsSubsystemsSelectAll
ПодсистемыПодсистемыСнятьПометки=SubsystemsSubsystemsClearAll
ПодсистемыСнятьПометки=SubsystemsClearAll
Подтвердить=Confirm
ПодтвердитьИзменение=ConfirmUpdate
ПодтвердитьИзменения=ConfirmChanges
ПодтверждениеОбработано=ConfirmationProcessed
ПоказатьИнструкциюПоСозданиюФаксимильнойПодписиИПечати=ShowInstructionOnHowToCreateFacsimileSignatureAndSeal
ПоказатьКодВариантВторой=ShowCodeOptionTwo
ПоказатьКодВариантПервый=ShowCodeOptionOne
ПоказатьКодВариантТретий=ShowCodeOptionThree
ПоказатьКодВариантЧетвертый=ShowCodeOptionFour
ПоказатьМестаИспользования=ShowUsageInstances
ПоказатьПланВыполненияЗапроса=ShowQueryExecutionPlan
ПоказатьПланВыполненияЗапросаПропуск=ShowQueryExecutionPlanSkip
ПоказатьПомеченныеНаУдаление=ShowObjectsMarkedForDeletion
ПоказатьСообщение=ShowMessage
ПоказатьСообщениеПоляФормыСвязанногоСРеквизитомОбъекта=ShowMessageForFormFieldLinkedToObjectAttribute
ПоказатьСообщениеПоляФормыСвязанногоСРеквизитомОбъектаНаКлиенте=ShowMessageForFormFieldLinkedToObjectAttributeAtClient
ПоказатьСообщениеПоляФормыСвязанногоСРеквизитомОбъектаНаСервере=ShowMessageForFormFieldLinkedToObjectAttributeAtServer
ПоказатьСообщениеПоляФормыСвязанногоСРеквизитомФормыНаКлиенте=ShowMessageForFormFieldLinkedToFormAttributeAtClient
ПоказатьСообщениеПоляФормыСвязанногоСРеквизитомФормыНаСервере=ShowMessageForFormFieldLinkedToFormAttributeAtServer
ПоказатьСообщениеСвязанноеСРеквизитомОбъектаИнформационнойБаз=ShowInfobaseObjectAttributeMessage
ПоказатьСообщениеСвязанноеСРеквизитомОбъектаИнформационнойБазы=ShowMessageAssociatedWithInfobaseObjectAttribute
ПоказатьСообщениеСвязанноеСРеквизитомОбъектаИнформационнойБазыПоСсылкеНаКлиенте=ShowMessageAssociatedWithInfobaseObjectAttributeByRefAtClient
ПоказатьСообщениеСвязанноеСРеквизитомОбъектаИнформационнойБазыПоСсылкеНаСервере=ShowMessageAssociatedWithInfobaseObjectAttributeByRefAtServer
ПоказатьСохраненнуюИнформациюОбОбновлении=ShowSavedUpdateInformation
ПоказатьТекстДляВставки=ShowTextToInsert
ПоказатьТекстДляВставкиДляВнешнихПользователей=ShowTextToInsertForExternalUsers
ПоказыватьВыполненныеЗадания=ShowExecutedJobs
ПоказыватьИнформациюЧтоФайлНеБылИзменен=ShowFileNotModifiedFlag
ПоказыватьКолонкуРазмер=ShowSizeColumn
ПоказыватьОписаниеИзмененийСистемы=ShowSystemChangesDetails
ПоказыватьПланВыполненияЗапроса=ShouldShowQueryExecutionPlan
ПоказыватьПланВыполненияЗапросаВВиде=ShowQueryExecutionPlanAs
ПоказыватьПодсказкиПриРедактированииФайлов=ShowTooltipsOnEditFiles
ПоказыватьПредупреждениеОбУстановленныхОбновленияхПрограммы=ShowInstalledApplicationUpdatesWarning
ПоказыватьПредупреждениеПриРегистрации=ShowRegistrationMessage
ПоказыватьСчетаВНедействующихБанках=ShowAccountsInInactiveBanks
ПолеВыбораПапкиНачалоВыбора=FolderChoiceFieldStartChoice
ПолеВыбораПапкиОткрытие=FolderChoiceFieldOpen
ПолеВыбораПапкиПриИзменении=FolderChoiceFieldOnChange
ПолеОтступа=IndentField1
ПолнаяСтруктураОбъекта=FullObjectStructure
ПолныйПутьКФайлуПроверки=FullPathToCheckFile
ПолучатьПланВыполненияЗапроса=GetQueryExecutionPlan
ПолучатьПредшествующие=GetPrevious
ПолучениеНаСервере=GetAtServer
ПолучениеОграничений=GetRestrictions
ПолучитьВременныйПарольДругимСпособом=GetTempPasswordUsingAnotherMethod
ПолучитьДатыРабочихДней=GetWorkdaysDates
ПолучитьИнформацию=GetInformation
ПолучитьИнформациюОПользователяхСервиса=GetServiceUsersInformation
ПолучитьКодРегистрации=GetRegistrationCode
ПолучитьПодтверждение=GetConfirmation
ПолучитьФайл=GetFile
ПользователиГруппа1=UsersGroup1
ПользователиЗаблокирован=UsersLocked
ПользователиИмяПользователя=UsersUsername
ПользователиКонтекстноеМенюГруппа1=UsersContextMenuGroup1
ПользователиКонтекстноеМенюЗаблокироватьПользователя=UsersContextMenuLockUser
ПользователиКонтекстноеМенюНайти=UsersContextMenuFind
ПользователиКонтекстноеМенюОтменитьПоиск=UsersContextMenuCancelSearch
ПользователиКонтекстноеМенюРазблокироватьПользователя=UsersContextMenuUnlockUser
ПользователиПолноеИмя=UsersFullName
ПользователиЭтоПользовательИБ=UsersIsIBUser
ПользователиЭтоПользовательСистемыВзаимодействия=UsersIsCollaborationSystemUser
ПользовательСервиса=SaaSUser
ПоменятьНаправлениеПеревода=ChangeTranslationDirection
ПоРолиИсполнителя=ByPerformerRole
ПорядокОбновленияСервер=UpdateOrderServer
ПорядокОбновленияФайл=UpdateOrderFile
ПорядокПрав=RightsOrder
ПосмотретьКодВариантВторой=ViewCodeOptionTwo
ПосмотретьКодВариантПервый=ViewCodeOptionOne
ПосмотретьКодВариантТретий=ViewCodeOptionThree
ПосмотретьКодВариантЧетвертый=ViewCodeOptionFour
ПоставляемыеДанныеГруппа=SuppliedDataGroup
ПоставляемыеПрофилиГруппДоступа=SuppliedAccessGroupProfiles
Пояснение1=Explanation1
Пояснение2=Explanation2
Пояснение3=Explanation3
Пояснение4=Explanation4
ПояснениеДляПоиска=NoteForSearch
ПояснениеИмяКонфигурацииВОбменеСБиблиотекойСтандартныхПодсистем=ConfigurationNameForExhangeWithStandardSubsystemsLibraryNote
ПояснениеПодтвержденияИзменений=ChangesConfirmationNote
ПояснениеПодтвержденияИзмененияТелефонаОбработкаНавигационнойСсылки=PhoneChangeConfirmationNoteURLProcessing
ПоясняющаяНадпись3=NoteLabel3
ПоясняющаяНадпись4=NoteLabel4
ПравилаОтправкиДанных=DataSendingRules
ПравилаПолученияДанных=DataReceivingRules
ПравилаСинхронизацииДанных=DataSynchronizationRules
ПравилоОтбораСправочников=CatalogsFilterRule
ПредлагатьПерейтиНаСайтПриЗапуске=SuggestOpenWebSiteOnStart
ПредставлениеАдресаДоставки=DeliveryAddressPresentation
ПредставлениеСертификата=CertificatePresentation
ПредставлениеСопоставленияПользователей=UsersMappingPresentation
ПредставлениеФайла=FilePresentation
ПредставлениеФайла1=FilePresentation1
ПредставлениеФайла2=FilePresentation2
ПредставлениеЭлектроннойПочты=EmailRepresentation
ПредупреждениеБезопасностиДанОтвет=SecurityWarningAnswered
ПредыдущийСтатусЗаказа=PreviousOrderStatus
ПрерватьВнедрение=CancelIntegration
ПрерватьЗапись=CancelWrite
ПрерываниеРазрешено=AbortAllowed
ПрефиксЛинейнойСвязи=LinearRelationPrefix
Приложение1=Package1
Приложение2=Package2
ПриложениеЗарегистрировано=ApplicationRegistered
ПриниматьВыручкуОбщейСуммойПереключатель=AcceptRevenueAsTotalAmountRadioButton
Проведение=Posting
ПроверитьАдрес=ValidateAddress
ПроверитьВходящие=CheckIncoming
ПроверитьВходящиеВыполнить=CheckIncomingMessagesExecute
ПроверитьНазначениеРолей=CheckRoleAssignment
ПроверитьНомер=ConfirmPhoneNumber
ПроверитьОграничение=CheckRestriction
ПроверитьТекстОграничения=CheckRestrictionText
ПроверитьТекстОграниченияДляВнешнихПользователей=CheckRestrictionTextForExternalUsers
ПроверкаТелефонДляПаролей=ConfirmPhoneNumberForPasswords
ПроверкаТелефонСтарый=ConfirmOldPhoneNumber
ПроверкаЭлектроннаяПочтаДляПаролей=ConfirmEmailForPasswords
ПроверкиНомерСтроки=ChecksRowNumber
ПроверятьЗаполнение=CheckFilling
ПроверяющийПоНазначению=SupervisorByAssignment
ПровестиИЗакрыть=PostAndClose
ПровестиСчетФактуруПолученный=PostReceivedTaxInvoice
ПрограммноеЗакрытие=CloseProgrammatically
ПродавецСумма=SellerSum
ПродолжитьРаботуНаТекущейВерсии=ContinueWorkingWithCurrentVersion
ПрозрачныйФон=Transparent
ПроизводственныеКалендариСтраница=BusinessCalendarsPage
ПростаяЗагрузка=SimpleImport
ПростаяНастройка=SimpleSetup
ПростойТип=BasicType
ПростыеДублиИспользование=SimpleDuplicatesUsage
ПростыеДублиКоличество=SimpleDuplicatesCount
ПростыеДублиПрефикс=SimpleDuplicatesPrefix
ПроходовГенерации=GenerationPasses
ПрочиеСценарии=OtherScenarios
ПрочиеСценарииИспользование=OtherScenariosUsage
ПрочиеСценарииПрефикс1=OtherScenariosPrefix1
ПрочиеСценарииПрефикс2=OtherScenariosPrefix2
ПрочиеСценарииПрефикс3=OtherScenariosPrefix3
ПрочиеСценарииПрефикс4=OtherScenariosPrefix4
ПрочиеСценарииПрефикс5=OtherScenariosPrefix5
ПускБезКонтроля=StartWithoutControl
ПускСКонтролем=StartWithControl
ПустаяСтрока=IsBlankString
ПустаяСтрока1=IsBlankString1
ПутьКВложению=PathToAttachment
ПутьКВнешнейКонсолиЗапросов=PathToExternalQueryConsole
ПутьКИБ=IBPath
ПутьКФайлуПредыдущейВерсииКонфигурации=PathToPreviousConfigurationVersionFile
ПутьНаКлиенте=PathAtClient
ПутьНаСервере=PathAtServer
ПутьФайлаLinux=LinuxFilePath
ПутьФайлаWindows=WindowsFilePath
РаботаВВебКлиенте=WebClientOperations
РаботаВПрограммеЗапрещена=MustExit
РабочаяДата=WorkingDate
РазблокироватьПользователя=UnlockUser
Развернут=Expanded
Развернута=IsExpanded
РазмерВыбранныхИсправлений=SelectedCorrectionsSize
РазмерПорции=PortionSize
РазностьДат=DateDiff
РазработкаОграниченийКоманды=CommandRestrictionsDevelopment
РазработкаОграниченияДоступа=AccessRestrictionDevelopment
РазрешитьЗапретитьРедактирование=AllowDenyEditing
Раскомментировать=Uncomment
РасписаниеЗагрузки=ImportSchedule
РасставитьФрагментыКода=ArrangeCodeSnippets
РассчитатьДату=CalculateDate
РассчитатьЗначение=CalculateValue
РассчитатьКоличествоДней=CalculateDaysCount
РассчитатьМассивДат=CalculateDatesArray
РассчитатьОграничениеВРоли=CalculateRestrictionInRole
РассчитатьОграничениеВРолиДляВнешнихПользователей=CalculateRestrictionInRoleForExternalUsers
РассчитыватьСледующуюДатуОтПредыдущей=CalculateNextDateFromPrevious
РасширениеРаботыСФайламиУстановлено=FileSystemExtensionInstalled
РегистрацияКодПодтверждения=RegistrationConfirmationCode
РегистрацияНаименование=RegistrationDescription
РегистрацияРазрешена=RegistrationAllowed
РегистрацияТелефон=RegistrationPhone
РегистрацияЭлектроннаяПочта=RegistrationEmail
РегистрСведенийРеестрДокументов=InformationRegisterDocumentsRegistry
РегистрыНакопленияИспользование=AccumulationRegistersUsage
РегистрыНакопленияКоличество=AccumulationRegistersCount
РегистрыНакопленияПрефикс=AccumulationRegistersPrefix
РегистрыСведенийИспользование=InformationRegistersUsage
РегистрыСведенийКоличество=InformationRegistersCount
РегистрыСведенийПрефикс=InformationRegistersPrefix
РедактироватьИнтерактивно=EditInteractively
Реестр=Register3
РеестрДокументов=DocumentsRegistry
РежимВводаНастроекКлиентаЛицензирования=LicensingClientSettingsInputMode
РежимВыбораСтроки=RowChoiceMode
РежимВыгрузки=ExportMode
РежимВыгрузкиДляТехническойПоддержки=ExportModeForTechnicalSupport
РежимОткрытияИзФормы=OpenFromFormMode
РежимРаботыНаКлиенте=OperatingModeAtClient
РежимРаботыНаКлиентеИлиНаСервере=OperatingModeAtClientOrAtServer
РежимСинхронизацииДанных=DataSynchronizationMode
РежимСинхронизацииОрганизаций=CompaniesSynchronizationMode
РежимСинхронизацииПодразделений=DepartmentsSynchronizationMode
РежимСинхронизацииСкладов=WarehousesSynchronizationMode
РежимУстановкиКомпонентаПлатформы=PlatformComponentInstallationMode
РежимУстановкиПлатформы=PlatformInstallationMode
РежимФормы=FormMode
РежимыВыводыИнформации=InformationOutputModes
РезультатГруппа=ResultGroup1
РезультатЗапросаКонтекстноеМенюГруппа1=QueryResultContextMenuGroup1
РезультатЗапросаКонтекстноеМенюГруппа2=QueryResultContextMenuGroup2
РезультатЗапросаКонтекстноеМенюГруппа3=QueryResultContextMenuGroup3
РезультатЗапросаПечать=QueryResultPrint
РезультатСохранения=SavingResult
РезультатСравнения=ComparisonResult
РезультатыЗамеров=MeasurementsResults
РезультатыЗамеровЗначение=MeasurementsResultsValue
РеквизитБанкаПриИзменении=BankDetailOnChange
РеквизитВладельца=OwnerAttribute
РеквизитФормы=FormAttribute
РеквизитыБанкаРасчетов=SettlementBankDetails
РешаемаяКольцеваяЗависимость=SolvableCircularDependency
РешаемаяКольцеваяЗависимостьДлина=SolvableCircularDependencyLength
РешаемаяКольцеваяЗависимостьИспользование=SolvableCircularDependencyUsage
РешаемаяКольцеваяЗависимостьКоличество=SolvableCircularDependencyCount
РешаемаяКольцеваяЗависимостьПрефикс=SolvableCircularDependencyPrefix
Родитель_КонтекстноеМеню=ParentContextMenu
РолиПользователейИнформационнойБазы=InfobaseUsersRoles
РольПроверяющегоСтрокой=SupervisorRoleString
РольСтрокой=RoleString
РучноеИзменениеТекстаНаименованияОрганизации=CompanyDescriptionTextManualEdit
СброситьИзменения=ClearChanges
СброситьСведенияОбОбновлении=ClearUpdateInformation
СведенияОСчете=AccountDetails
СВИФТБИК1=SWIFTBIC1
СВИФТБИКДляРасчетов1=PaymentSWIFTBIC1
СвойстваВидовДоступа=AccessKindsProperties
СвойстваВидовПользователей=UserKindsProperties
СвойстваВременногоФайла=TempFileProperties
СвязатьсяСоСпециалистом=ContactSpecialist
СвязатьсяСоСпециалистомПоддержки=ContactASupportSpecialist
СвязиПриложений=ApplicationsLinks
СвязиПриложенийГруппа1=ApplicationsLinksGroup1
СвязиПриложенийГруппаСопоставления=ApplicationsLinksMappingGroup
СвязиПриложенийДобавить1=ApplicationsLinksAdd1
СвязиПриложенийИзменить1=ApplicationsLinksChange1
СвязиПриложенийСопоставлениеОбсуждений=ApplicationsLinksConversationsMapping
СвязиПриложенийУдалить1=ApplicationsLinksDelete1
Сгенерировать=Generate
СерверБазы=InfobaseServer
СервисСопровождения=MaintenanceService
СинхронизацияДокументов=DocumentsSynchronization
СинхронизацияСправочников=CatalogsSynchronization
СистемнаяУчетнаяЗапись=SystemAccount
СкладыНомерСтроки=WarehousesRowNumber
Склонения=Declensions
СкопироватьЗапрос=CopyQuery
СкопироватьСтроки=CopyRows
СкоростьВыполнения=ExecutionSpeed
СложнаяНастройка=AdvancedSetup
Служебные=Utilities
СмотритеТакже=SeeAlso_3
СнятьВсеПроверки=ClearAllChecks
СнятьОтметку=ClearMark1
СнятьОтметкуСоВсех=ClearAll3
Согласен=Agree
СоздатьДокументы=CreateDocuments
СоздатьЗадачу=CreateTask
СоздатьЗадачуВыполнить=CreateTaskExecute
СоздатьОбъекты=CreateObjects
СоздатьПеремещения=CreateMoves
СоздатьПроект=CreateProject
СоздатьПроектСейчас=CreateProjectNow
СоздатьРезервнуюКопиюУстановлено=CreateBackupSet
СоздатьСвязанные=CreateLinkedItems
СоздатьТекстЗапросаДляКонфигуратора=CreateQueryTextForDesigner
СоздатьФайлыДляПереноса=CreateFilesToTransfer
Сообщение1=Message1
СопоставлениеКонтекстныхОбсуждений=ContextConversationsMapping
СопоставлениеОбсуждений=ConversationsMapping
СопоставлениеПользователей=UserMatching
СоставНомерСтроки=CompositionRowNumber
СоставПользователь=CompositionUser
СостояниеБанка=BankStatus
СостояниеБанкаНепрямыхРасчетов=IntermediaryBankStatus
СостояниеЗапроса=QueryStatus
СостояниеОригиналПолучен=StateOriginalReceived
СостояниеРегистрацииВСервисе=RegistrationInServiceState
СотрудникиНомерСтроки=EmployeesLineNumber
СохранитьВариантыОтчетов=SaveReportOptions
СохранитьДанныеАутентификации=SaveAuthenticationData
СохранитьЗапросыВДругойФайл=SaveQueriesToAnotherFile
СохранитьЗапросыВФайл=SaveQueriesToFile
СохранитьИЗагрузить=SaveAndImport
СохранитьНастройкиВФайл=SaveSettingsToFile
СохранитьНастройкиДляКонфигуратора=SaveSettingsForDesigner
СохранитьСопоставлениеСПользователямиСервиса=SaveMappingToServiceUsers
СохраняемоеЗначениеПароля=StoredPasswordValue
СохранятьДистрибутивыКомпонентаПлатформыВКаталог=SavePlatformComponentDistributionPackagesToDirectory
СохранятьДистрибутивыКомпонентаПлатформыВКаталог1=SavePlatformComponentDistributionPackagesToDirectory1
СохранятьДистрибутивыПлатформыВКаталог=SavePlatformDistributionPackagesToDirectory
СохранятьПропорции=MaintainAspectRatio
СписокВалютаРасчетов_КонтекстноеМеню=SettlementCurrencyListContextMenu
СписокВладелец_КонтекстноеМеню=OwnerListContextMenu
СписокВыбираемыхЗначений=ListOfSelectedValues
СписокВыбираемыхЗначенийКнопкаЗаписатьЗакрыть=ListOfSelectedValuesRecordCloseButton
СписокВыбираемыхЗначенийКнопкаОтметитьВсе=ListOfSelectedValuesMarkAllButton
СписокВыбираемыхЗначенийКнопкаСнятьПометки=ListOfValuesToSelectUncheckButton
СписокВыбораПунктов=PointsSelectionList
СписокГруппаКомандыСписка=ListListCommandsGroup
СписокДатаДоговора_КонтекстноеМеню=ContractDateListContextMenu
СписокДатаНачалаДействия_КонтекстноеМеню=ValidityStartDateListContextMenu
СписокДатаОкончанияДействия_КонтекстноеМеню=ValidityEndDateListContextMenu
СписокИсключений=ExceptionsList
СписокКод_КонтекстноеМеню=CodeListContextMenu
СписокКонтекстноеМенюГрупповоеИзменениеОбъектов=ListContextMenuBatchObjectModification
СписокКонтекстноеМенюКоманды=ListContextMenuCommands
СписокКонтекстноеМенюОсновныеКоманды=ListContextMenuMainCommands
СписокКонтекстноеМенюПроведение=ListContextMenuPosting
СписокКонтекстноеМенюСоздать=ListContextMenuCreate
СписокКонтекстноеМенюСправочник_ДемоПроектыСделатьОсновным=ListContextMenuCatalog_DemoProjectsMakeDefault
СписокМОЛ_КонтекстноеМеню=ICListContextMenu
СписокНаименование_КонтекстноеМеню=DescriptionListContextMenu
СписокНастройкиОтбора=SelectionSettingsList
СписокНомерДоговора_КонтекстноеМеню=ContractNumberListContextMenu
СписокОрганизаций=CompaniesList
СписокОрганизацийПометка=CompaniesListMark
СписокОрганизацийПредставление=CompaniesListPresentation
СписокПодразделение=ListDepartment
СписокПодразделение_КонтекстноеМеню=DepartmentListContextMenu
СписокПодразделениеДт=DepartmentDrList
СписокПодразделениеКт=DepartmentCrList
СписокПоказатьСообщение=ShowMessageList
СписокПолноеИмя=ListFullName
СписокПолноеИмяКоллекции=FullCollectionNameList
СписокПояснение=NoteList
СписокПриАктивизацииСтроки=ListOnActivateRow
СписокПриложенийПометка=ApplicationsMarkList
СписокПриложенийПредставление=ApplicationsListPresentation
СписокПроектов=ProjectsList
СписокРеализаций=SalesList
СписокСчетовФактур=TaxInvoicesList
СписокТипМестаХранения=StorageTypeList
СписокТипМестаХранения_КонтекстноеМеню=StorageTypeListContextMenu
СписокТипов=TypesList
СпособДоставкиПаролей=PasswordsDeliveryMethod
СпособЗаполненияРеквизитовИРеквизитыБанкаДляРасчетов=BankDetailsProvisionMethodAndSettlementBankDetails
СпособОткрытия=OpeningMethod
СпособПодключения=ConnectionMethod
СпособПодтвержденияКриптоопераций=CryptoOperationsConfirmationMethod
СпособРегистрации=RegistrationMethod
СпособУказанияРеквизитовБанка=BankDetailsAcquisitionMethod
СпособУказанияРеквизитовБанкаРасчетов=SettlementBankDetailsAcquisitionMethod
СпособУказанияРеквизитовИРеквизитыБанка=BankDetailsAcquisitionMethodAndBankDetails
СправкаПоОбработке=DataProcessorHelp
Справочник_ДемоКонтактныеЛицаПартнеровПереопределяемый=Directory_DemoContactPersonsPartnersOverridable
Справочник_ДемоПартнерыПереопределяемый=Directory_DemoPartnersOverridable
Справочник_ДемоФизическиеЛицаПереопределяемый=Catalog_DemoIndividualsOverridable
СправочникБИК=CatalogBIC
СпрашиватьРежимРедактированияПриОткрытииФайла=PromptForEditModeOnOpenFile
СравнениеФайловВоВнешнейПрограмме=FileComparisonInExternalApplication
СравнитьВоВнешнейПрограмме=CompareInExternalApplication
СравнитьРезультатыЗапросов=CompareQueriesResults
СравнитьТекстыRLS=CompareRLSTexts
СравнитьФайлыПриложений=CompareApplicationFiles
СреднийРазмерСтрок=AverageRowSize
СсылкаНаВнешнююСистему=ExternalSystemRef
СсылкаНаДанные=DataRef
СсылкаПоискаИнформации=InformationSearchRef
СтавкаНДСОписание=VATRateDetails
Стало=CurrentText
СтатусКода=CodeStatus
СтатусПароля=PasswordStatus
СтекСтраниц=PagesStack
Стоимость=Cost
СтоимостьОбщая=CostTotal
СтраницаАгентскиеУслуги=AgentServicesPage
СтраницаАдресСервиса=ServiceAddressPage
СтраницаАнализМодулей=ModulesAnalysisPage
СтраницаАналоги=AnalogsPage
СтраницаБанк=BankPage
СтраницаВводПароля=PasswordInputPage
СтраницаВводПароляКоманднаяПанель=PasswordInputPageCommandBar
СтраницаВсеПоля=AllFieldsPage
СтраницаВыборАбонента=SubscriberSelectionPage
СтраницаВыгрузкаКонфигурации=PagesConfigurationExport
СтраницаДва=TwoPage
СтраницаДекорацииНачало=DecorationPageStart
СтраницаДекорацииОкончание=DecorationPageEnd
СтраницаДекорацииПродолжение=DecorationPageFollowUp
СтраницаДоступнаяВерсияПлатформы=AvailablePlatformVersionPage
СтраницаЗавершение=PageCompletion
СтраницаЗарегистрированныйПользователь=RegisteredUserPage
СтраницаЗначенияПоУмолчанию=DefaultValuePage
СтраницаИдентификационныеДанные=IDDataPage
СтраницаИдентификационныеДанныеСтраницы=PageIDDataPage
СтраницаИнформацияОДоступномОбновленииКомпонентов=InformationOnAvailableComponentUpdatePage
СтраницаКнопки=ButtonsPage
СтраницаКод=CodePage
СтраницаКомандыВводПароля=CommandsPasswordInputPage
СтраницаКомандыОжидание=WaitCommandPage
СтраницаКомандыОшибка=ErrorCommandPage
СтраницаНастройкаПечати=PrintSettingsPage
СтраницаНастройкиВнедрения=DeploymentSettingsPage
СтраницаНерекомендуемаяВерсияПлатформы=PlatformVersionNotRecommendedPage
СтраницаНетНовойВерсииПлатформы=NoNewPlatformVersionAvailablePage
СтраницаНеУдалосьПодключитьсяКСервису=ServerConnectionFailedPage
СтраницаНовыйПользователь=NewUserPage
СтраницаОдин=OnePage
СтраницаОжиданиеКоманднаяПанель=PageWaitCommandBar
СтраницаОжиданиеОкончанияВнедрения=WaitForImplementationCompletionPage
СтраницаОжидания=WaitingPage
СтраницаОплата=PaymentPage
СтраницаОрганизации=CompaniesPage
СтраницаОсновные=PageBasic
СтраницаОтборПоДате=FilterByDatePage
СтраницаОтборПоОрганизации=FilterByCompanyPage
СтраницаОтборПоПодразделению=FilterByDepartmentPage
СтраницаОтборПоСкладу=FilterByWarehousePage
СтраницаОшибкаКоманднаяПанель=ErrorPageCommandBar
СтраницаПартнерыИКонтактныеЛица=PartnersAndContactPersonsPage
СтраницаПерезагрузкиСейчас1=RestartNowPage1
СтраницаПлатформаУжеУстановлена=PlatformAlreadyInstalledPage
СтраницаПодключениеКПорталу=ConnectionToPortalPage
СтраницаПодразделения=DepartmentsPage
СтраницаПодтверждениеРегистрации=PageRegistrationConfirmation
СтраницаПолучение=AcquisitionPage
СтраницаПолучениеЗавершено=AcquisitionCompletedPage
СтраницаПолучениеИУстановка=AcquisitionAndInstallationPage
СтраницаПользователи=UsersPage1
СтраницаПраваПользователей=UsersRightsPage
СтраницаПрогресс=ProgressPage
СтраницаПросмотрРезультатовВнедрения=ViewImplementationResultsPage
СтраницаПять=PageFive
СтраницаРабочегоСтола=DesktopPage
СтраницаРеализации=SalesPage
СтраницаРегистрации=RegistrationPage
СтраницаРегистрация=RegistrationPage1
СтраницаРезультат=ResultPage
СтраницаСвязиПриложений=ApplicationsLinksPage
СтраницаСкладскиеДокументы=WarehouseDocumentsPage
СтраницаСклады=WarehousesPage
СтраницаСозданиеПриложение=CreateApplicationPage
СтраницаСообщениеСервиса=ServiceMessagePage
СтраницаСопоставлениеПользователей=UsersMappingPage
СтраницаСчетаНаОплату=ProformaInvoicesPage
СтраницаТаблица=TablePage
СтраницаТаблицаСТЧ=TableWithTSPage
СтраницаТовары=GoodsPage
СтраницаТри=PageThree
СтраницаУведомление=NotificationPage
СтраницаУстановкаИнтерактивный=InteractiveInstallationPage
СтраницаУстановкаПлатформыЗавершена=PlatformInstallationCompletedPage
СтраницаУстановкаТихий=QuietInstallationPage
СтраницаУстановленыИсправления=PageInstallCorrections
СтраницаЧетыре=PageFour
СтраницыИнструкцияУстановкаЗавершена=PagesInstructionInstallationCompleted
СтраницыИнструкцияУстановкаУстановлена=InstructionInstallationInstalledPages
СтраницыИнформацииПерезагрузки1=RestartInformationPages1
СтраницыПодключения=ActivationPages
СтраницыПолучениеУстановка=AcquisitionInstallationPages
СтрЗавершеноНеСоздаватьРК=CompletedDoNotCreateBackupPage
СтрЗавершеноСоздатьРК=CompletedCreateBackupPage
СтрокаЗапускаВнешнейПрограммы=ExternalApplicationCommandLine
СтрокаСоединения=ConnectionString
СтрокиПлан=PlanRows
СтрокиФакт=FactRows
Строковый=AttributeString
СтруктураАктивнойОбласти=ActiveAreaStructure
СтруктураЗаполняемыхЗначений=StructureOfFilledValues
СтруктураТабличныхДокументов=SpreadsheetDocumentsStructure
СтрУстановленаНеСоздаватьРК=InstalledDoNotCreateBackupPage
СтрУстановленаСоздатьРК=InstalledCreateBackupPage
Субконто1=ExtDimension1
Субконто2=ExtDimension2
Субконто3=ExtDimension3
СуммаИСуммаНДС=SumAndSumVAT
СуммарнаяСтоимостьЗапроса=TotalQueryCost
СуммаСтатусКомментарий=AmountStatusComment
СУсловиямиОзнакомлен=IUnderstandConditions
СформированныйSQLТекстЗапроса=GeneratedSQLQueryText
СформированныйСКЛТекстЗапроса=GeneratedSQLQuery
СформироватьМакеты=GenerateTemplates
СформироватьОписаниеВидовДоступаПоПравам=GenerateAccessKindsDetailsByRights
СформироватьОписаниеПрофилей=GenerateProfilesDetails
СформироватьОписаниеПрофилейВыполнить=GenerateProfilesDetailsExecute
СформироватьОписаниеРазличий=GenerateDifferencesDetails
СформироватьПечатнуюФорму=GeneratePrintForm
СформироватьПолноеОписание=GenerateFullDetails
СформироватьПоставляемыеДанные=GenerateSuppliedData
СформироватьРазличияОписанийВидовДоступаПоПравам=GenerateDifferencesForAccessKindsDetailsByRights
СформироватьФайлНастроек=GenerateSettingsFile
СчетаНаОплатуНомерСтроки=ProformaInvoicesRowNumber
СчитатьПараметрыИзТекстаЗапроса=ReadParametersFromQueryText
ТаблицаВидыДокументов=DocumentsKindsTable
ТаблицаДанныхОбласти=AreaDataTable
ТаблицаДатПоКалендарю=DatesOnCalendarTable
ТаблицаЗначенийПараметр=ValueTableParameter
ТаблицаНовостей=NewsTable
ТаблицаОбъекта=ObjectTable
ТаблицаОтбора=FilterTable
ТаблицаСсылок=RefsTable
ТаблицаШтрихкодов=BarcodeTable
ТабличныеЧасти=TabularSections
ТабличныйДокументБезТЧ=SpreadsheetDocumentWithoutTS
ТабличныйДокументКоманднаяПанель=SpreadsheetDocumentCommandBar
Таймер=Timer
ТаймерОкончание=TimerEnd
ТаймерСрока=PeriodTimer
ТекстВМодулеМенеджера=TextInManagerModule
ТекстВыбраноИсправлений=TextSelectedCorrections
ТекстДлительноеВремя=TimeConsumingText
ТекстЗапросаВSQL=QueryTextInSQL
ТекстЗапросаВВидеМетаданных=QueryTextAsMetadata
ТекстЗапросаКонтекстноеМенюГруппаОформление=QueryTextContextMenuGroupAppearance
ТекстЗапросаКонтекстноеМенюГруппаСервис=QueryTextContextMenuGroupService
ТекстЗащитаОтОпасныхДействий=ProtectionFromHarmfulActionsText
ТекстКонфигурацияИзменена=ConfigurationModifiedText
ТекстОбъектовВыгруженоЗагружено=ObjectsExportedImportedText
ТекстОграничения=RestrictionText
ТекстОграниченияВРоли=RestrictionTextInRole
ТекстОграниченияВРолиДляВнешнихПользователей=RestrictionTextInRoleForExternalUsers
ТекстОграниченияДляВнешнихПользователей=RestrictionTextForExternalUsers
ТекстОграниченияЗаголовок=RestrictionTextHeader
ТекстОграниченияЗаголовокДляВнешнихПользователей=RestrictionTextHeaderForExternalUsers
ТекстОграниченияЗаголовокИКоманды=RestrictionTextHeaderAndCommands
ТекстОграниченияЗаголовокИКомандыДляВнешнихПользователей=RestrictionTextHeaderAndCommandsForExternalUsers
ТекстОсталосьВыгрузитьЗагрузить=LeftToExportImportText
ТекстОткрытКонфигуратор=DesignerOpenedText
ТекстОшибокОграничения=RestrictionErrorsText
ТекстОшибокОграниченияДляВнешнихПользователей=RestrictionErrorsTextForExternalUsers
ТекстПеревода=TranslationText
ТекстПолучениеПланаВыполненияЗапроса=GetQueryExecutionPlanText
ТекстСообщенийОтправленоОбработано=MessagesSentProcessedText
ТекущаяИБ=CurrentIB
ТекущаяКомпонента=CurrentAddIn
ТекущаяОбластьДанных=CurrentDataArea
ТекущееДействие=CurrentAction1
ТекущееСостояние=CurrentState
ТекущийШаг=CurrentStep
ТелефонДляПаролей=PhoneForPasswords
ТемаЗадачи=Task_Subject
ТемаПоручения=InstructionSubject
ТехнологическийЖурналДоступен=TechnologicalLogAvailable
ТипАутентификации=AuthenticationType
ТипАутентификации1С=AuthenticationType1C
ТипАутентификацииОС=AuthenticationTypeOS
ТипАутентификацииПриИзменении=AuthenticationTypeOnChange
ТипВФорме=TypeInForm
ТипДокумента=DocumentType
ТипДокументаОрганизация=DocumentTypeCompany
ТипДокументаОтветственный=DocumentTypeEmployeeResponsible
ТипДрайвера=DriverType
Типизировать=ShouldBeTypified
ТипИсполнителя=PerformerType
ТипОбласти=AreaType
ТипОбъектовДляВыгрузки=ObjectsTypeToExport
ТипПоказаЗапроса=QueryShowType
ТипПроверяющего=SupervisorType
ТипШтрихкода=BarcodeType
ТипШтрихкодаЗнач=BarcodeTypeVal
ТоварыВставитьСтрокиМеню=GoodsInsertMenuRows
ТоварыНомерСтроки=GoodsLineNumber
ТоварыПоле=GoodsField
ТоварыСкопироватьСтрокиМеню=GoodsCopyMenuRows
ТолькоПроверка=CheckOnly1
ТолькоСВнешнимДоступом=ExternalAccessOnly
ТолькоСправочникиИДокументы=CatalogsAndDocumentsOnly
ТребуетсяВводГТД=CCDRequired
ТребуетсяМонопольныйРежим=ExclusiveModeRequired
ТребуетсяПрочитатьЖурналИмя=NeedToReadLogName
УбратьЛишнийФон=RemoveExtraBackgroud
Уведомление=Notification
УголПоворота=AngleOfRotation
УдалитьКодНеиспользуемыхПодсистем=DeleteUnusedSubsystemsCode
УжеВстроено=AlreadyBuiltIn
УровеньКоррекцииQR=QRErrorCorrectionLevel
УсловноЗависитОтПодсистем=ConditionallyDependsOnSubsystems
УстановитВсеФлажки=WillSelectAllCheckBoxes
УстановитьДатуЗапретаИзменений=SetPeriodEndClosingDate
УстановитьИсправления=InstallPatches
УстановитьКомпоненту=InstallAddInSSL
УстановитьКомпонентуИзМакета=InstallAddInFromTemplate
УстановитьПериод=SetPeriod
УстановитьРасширениеРаботыСФайламиНаКлиенте=InstallFileSystemExtensionAtClient
УстановитьСостояниеОригиналПолучен=SetStateOriginalReceived
УстановленаИнтеграцияСоСлужбойПоддержки=IntegrationWithSupportEstablished
УстановленныйПериод=PeriodSet
УчетнаяЗаписьВходящие=AccountIncoming
УчетныеЗаписи=Accounts_
Учитывать=Consider
УчитыватьНДСПриИзменении=ConsiderVATOnChange
ФайлЗаявления=ApplicationFile
ФайлыКонфигурацииВыгружены=ConfigurationFilesExported
ФизическоеЛицоКасса=IndividualCashRegister
ФильтрДиалога=DIalogBoxFilter
ФильтрПоМетаданным=FilterByMetadata
ФоновоеЗаданиеАнимация1=BackgroundJobAnimation1
ФоновоеЗаданиеПроцент1=BackgroundJobPercentage1
ФоновоеЗаданиеСостояние=BackgroundJobStatus2
ФоновоеЗаданиеСостояние1=BackgroundJobState1
ФормаВыполнить=FormExecute
ФормаГруппаАктивностьДвижений=FormRecordsActivityGroup
ФормаГруппаАктивностьПроводок=FormPostingActivityGroup
ФормаГруппаВстраиваемыеКоманды=FormCommandsToBuildGroup
ФормаГруппаДобавить=FormAddGroup
ФормаГруппаКнопок=FormButtonsGroup
ФормаГруппаУправление=FormManagementGroup
ФормаГрупповоеИзменениеОбъектов=FormBatchObjectModification
ФормаЗакрыть=FormClose
ФормаНачатьВыполнение=FormStartExecution
ФормаОбновитьТекущуюБазу=FormUpdateCurrentInfobase
ФормаОбработка_ДемоПереносФайловОткрыть=FormDataProcessor_DemoFilesTransferOpen
ФормаОбработка_ДемоПечатнаяФормаСписаниеТоваровMSWord=FormDataProcessor_DemoPrintFormWriteOffGoodsMSWord
ФормаОбработкаЖурналРегистрацииОткрыть=FormEventLogDataProcessorOpen
ФормаОбщаяКомандаВыполнитьОбменДанными=FormCommonCommandExecuteDataExchange
ФормаОбщаяКомандаВыполнитьОбменДаннымиИнтерактивно=FormCommonCommandExecuteDataExchangeInteractively
ФормаОбщаяКомандаИсторияИзменений=FormCommonCommandChangeHistory
ФормаОбщаяКомандаНастроитьПараметрыТранспортаСообщенийОбмена=FormCommonCommandSetExchangeMessagesTransportParameters
ФормаОбщаяКомандаОткрытьПравилаКонвертацииОбъектов=FormCommonCommandOpenObjectsConversionRules
ФормаОбщаяКомандаОткрытьПравилаРегистрацииОбъектов=FormCommonCommandOpenObjectsRegistrationRules
ФормаОбщаяКомандаПолучитьНастройкиОбменаДаннымиДляВторойИнформационнойБазы=FormCommonCommandGetDataExchangeSettingsForSecondInfobase
ФормаОбщаяКомандаСоставОтправляемыхДанных=FormCommonCommandCompositionOfDataToSend
ФормаОбщаяКомандаУдалитьНастройкуСинхронизации=FormCommonCommandDeleteSynchronizationSetting
ФормаОжидания=WaitForm
ФормаПерезапуститьСистему=FormRestartSystem
ФормаПереключитьАктивностьПроводок=FormSwitchPostingActivity
ФормаПодобрать=FormPick
ФормаПуск=FormStart
ФормаРасписание=FormSchedule
ФормаСправочникВнешниеКомпонентыОткрытьСписок=FormCatalogAddInsOpenList
ФормированиеШтрихкодов=BarcodesGeneration
ХранитьИсторию=StoreHistory
ЦентрИдей=IdeasCenter
ЦиклКриптооперации=CryptoOperationCycle
ЦифраИзменениеТекстаРедактирования=DigitEditTextChange
Цифры=Digits
ЧасовойПояс=TimeZone
ШагАвторизации=AuthorizationStep
ШапкаЛевая=LeftHeader
ШапкаПравая=RightHeader
ШапкаСлева=HeaderLeft
ШапкаСправа=HeaderRight
ШироковещательныйКанал=BroadcastChannel
ШтрихкодBase64=BarcodeBASE64
ЭлектроннаяПочтаДляПаролей=EmailForPasswords
ЭтоВыражение=IsExpression
ЭтоЛокальнаяБаза=IsLocalInfobase
ЭтоПовторноеНажатие=IsSecondClick
ЭтоПользовательИБ=IsIBUser
ЭтоПользовательСистемыВзаимодействия=IsCollaborationSystemUser
ЭтоРазделенныйСеанс=IsSeparatedSession
ЭтоТабличнаяЧасть=IsTabularSection
ЭтоФайловаяИБ=IsFileIB
ЭтоФормаБизнесПроцесса=IsBusinessProcessForm
ЮридическоеФизическоеЛицо=CompanyIndividual
ЯзыкТекста=TextLanguage
