#Translations for: 51_SSL_yandex_camelcase_demo

*Наименование=*Name
_ВидСубконто=SubKontoView
_ДемоБазовыеПраваПользователяБСП=_DemoBasicUserRightsBSP
_ДемоЗаказПокупателяПартнерыИКонтактныеЛица=DemoOrderOfTheBuyerPartnersAndContactPersons
_ДемоЗаказПокупателяСчетаНаОплату=_DemoOrderOfTheBuyerOfTheInvoiceForPayment
_ДемоЗаполнитьДатуДокументаПоРабочейДатеОбработкаЗаполнения=_DemoFillInTheDateOfTheDocumentByTheWorkingDateProcessingOfTheFilling
_ДемоИмяКонфигурацииВОбменеСБиблиотекойСтандартныхПодсистемПриИзменении=_DemoNameOfConfigurationInExchangeWithLibraryOfStandardSubsystemsWhenChanging
_ДемоИнтеграция1СБухфон=_DemoIntegration1CBuhphone
_ДемоИспользоватьКонтактныеЛицаПартнеровПриИзменении=_DemoUsePartnersContactPersonsWhenChanging
_ДемоКонтрагентыКонтактнаяИнформация=_DemoContractorsContactInformation
_ДемоНачислениеЗарплатыЗарплата=_DemoPayrollPayroll
_ДемоОбновитьРеестрСкладскихДокументовПриЗаписи=_DemoUpdateInventoryDocumentRegistryWhenRecording
_ДемоОсновнойБезКорреспонденции=_DemoBasicWithoutCorrespondence
_ДемоПереходНаУниверсальныйФормат=DemoSwitchingToAUniversalFormat
_ДемоПоступлениеТоваровТовары=_DemoReceiptOfGoodsGoods
_ДемоРабочийСегментПартнераРасширение=_DemoWorkingSegmentsPartnersExtension
_ДемоРеализацияТоваровТовары=DemoSaleOfGoodsGoods
_ДемоСегментыПартнеровРасширение=_DemoSegmentsPartnersExtension
_ДемоСчетНаОплатуПокупателюТовары=_DemoInvoiceForPaymentToTheBuyerOfGoods
_Организация=_Organization
_ПриДобавленииОбработчиковУстановкиПараметровСеанса=_WhenAddingHandlersForSettingSessionParameters
_ФизическоеЛицо=_Individual
15м=M15
1СПредприятие=1CEnterprise
abcdefghijklmnopqrstuvwxyzабвгдеёжзийклмнопрстуфхцчшщъыьэюя=abcdefghijklmnopqrstuvwxyzабвгдеёжзийклмнопрстуфхцчшщъыьэюя
Base64URLСтрока=Base64URLString
Integration1СBukhfon=IntegrationOf1CBukhfon
URIПространствИменСхемаКонфигурации=UriNamespacesConfigurationScheme
XDTOТипНастройкиКомпановкиДанных=XDTOTypeOfDataAlignmentSettings
Автозамена=Autocorrect
АвтоматическоеНапоминаниеОбИзмененииСостоянияЗаявления=AutoReminderAboutStateChangeStatement
АвтоматическоеНапоминаниеОПродленииСертификата=AutomaticCertificateRenewalReminder
АвторизоватьАбонента=AuthorizeSubscriber
АвторизоватьсяНаПочтовомСервере=LoginAtMailServer
АвтоТест=AutoTest_2
АгентскиеУслугиКоманднаяПанель=AgencyServicesCommandPanel
АгентскиеУслугиПриИзменении=AgencyServicesForChanges
АгентскиеУслугиСостояниеПросмотра=AgencyServicesViewingStatus
АгентскиеУслугиСтрокаПоиска=AgencyServicesSearchBar
АгентскиеУслугиУправлениеПоиском=AgencyServicesSearchManagement
АДОК=ADOK
АдресАбонента=SubscriberSAddress
АдресАнонимногоСервисаИнтеграцииСИнформационнымЦентромУСП=AddressOfAnonymousIntegrationServiceWithUSPInformationCenter
АдресаСерверовМетокВремениДляНачальногоЗаполнения=TimestampServerAddressesForInitialPopulation
АдресВерсииВнешнегоПрограммногоИнтерфейса=VersionAddressOfExternalSoftwareInterface
АдресВнешнегоАнонимногоИнтерфейсаУСП=AddressOfExternalAnonymousInterface
АдресВнешнегоИнтерфейса=ExternalInterfaceAddress
АдресВСвободнойФорме=CustomFormatAddress
АдресДляВыгрузки=UploadAddress
АдресДляЗагрузкиПриИзменении=AddressToUploadWhenChanging
АдресИнтернетРесурса=InternetResourceAddress
АдресИнформацииОПакетеУстановки=AddressInfoPacketSettings
АдресИсполненияВнешнегоПрограммногоИнтерфейса=ExecutionAddressOfExternalSoftwareInterface
АдресКонтактногоЛица=Contact_Address
АдресНачальногоОбраза=StartImageAddress
АдресПеренаправленияПоУмолчанию=RedirectAddressDefault
АдресПерехода=JumpAddr
АдресПочтыАбонентаДляИнтеграцииСУСП=SubscriberSEmailAddressForSuspIntegration
АдресРезальтата=AddressOfRezaltat
АдресРезультатаПотока=StreamResultAddr
АдресРезультатов=AddressResults
АдресСервисаИзЛокальнойБазы=ServiceAddressFromLocalDatabase
АдресСчета=AccountAddress
АдресСчетовНаОплатуУчетнойСистемыБиллинга=AddressOfInvoicesForPaymentOfBillingSystem
АдресЭлектроннойПочтыАбонентаИзменениеТекстаРедактирования=SubscriberEmailAddressEditTextChange
АдресЭлектроннойПочтыАбонентаПриИзменении=SubscriberEmailAddressOnChange
АккредитованныеУдостоверяющиеЦентры=AccreditedCertificationCenters
АктивацияКодаРегистрации=ActivatingRegistrationCode
АктивныеРасширенияИзменяющиеСтруктуруДанных=ActiveExtensionsThatChangeDataStructure
АктуальностьРасчетаРазмераПриложения=RelevanceOfApplicationSizeCalculation
АктуальныеПараметрыБлокировки=CurrentBlockingParameters
АнализируемыеПодсистемыНачалоВыбора=AnalyzedSubsystemsBeginningOfChoice
АналогиЗагрузкаИзФайла=AnalogsLoadingFromAFile
АналогиКоманднаяПанель=SubstitutesCommandBar
АналогиСостояниеПросмотра=SubstitutesViewStatus
АналогиСтрокаПоиска=SubstitutesSearchString
АналогиУправлениеПоиском=SubstitutesSearchControl
АнглийскаяВерсия=EnglishVersion
АннотироватьСсылочныеТипы=AnnotateReferenceTypes
АП=AP
АрхивКопии=CopyArchive
АрхивныеМеткиВремени=ArchivalTimestamps
АС=AC
АутентификацияПоЛогину=LoginAuthentication
БазаПодключенаКУСП=DatabaseIsConnectedByCusp
БазовыеПраваВнешнегоПользователя=BasicExternalUserRights
БазовыйРеестрРеквизитов=BaseRegisterDetails
базы=Bases
БезВстроенногоКриптопровайдера=WithoutEmbeddedCryptoprovider
БезИзменения=Un_changed
БезПрофиля=WithoutProfile
БезПрофиля3=WithoutProfile3
БезРасшифровки=WithoutDecryption
БезРедактирования=NoEdit
БиблиотекаСинхронизацииДанных=DataSyncLibrary
БизнесПроцесс_ДемоЗаданиеСРолевойАдресацией=BusinessProcessDemoTaskWithRoleAddressing
БИПИнформационноТехнологическоеСопровождение=OSLInformationTechnologySupport
БИПОткрытьНастройкиОнлайнОплат=BEEPOpenOnlinePaymentSettings
БИПОткрытьШаблоныСообщенийОнлайнОплат=BEEPOpenOnlinePaymentMessageTemplates
БИПОткрытьШаблоныСообщенийСБП=BEEPOpenMessageTemplatesSBP
БСПОбновлениеКонфигурации=BSPConfigurationUpdate
БТСОчередьЗаданий=BTSTaskQueue
БыстраяОтправка=QuickDispatch
ВалютаДт=CurrencyDr
ВалютаКт=CurrencyCr
ВалютнаяСуммаДт=CurrencyAmountDr
ВалютнаяСуммаКонечныйОстатокДт=CurrencyAmountClosingBalanceDr
ВалютнаяСуммаКонечныйОстатокКт=CurrencyAmountClosingBalanceCr
ВалютнаяСуммаКт=CurrencyAmountCr
ВалютнаяСуммаНачальныйОстатокДт=CurrencyAmountOpeningBalanceDr
ВалютнаяСуммаНачальныйОстатокКт=CurrencyAmountOpeningBalanceCr
ВалютнаяСуммаОборотДт=CurrencyAmountTurnoverDr
ВалютнаяСуммаОборотКт=CurrencyAmountTurnoverCr
ВариантАвтоматическоеНазначениеОО=OptionAutomaticOoAssignment
ВариантВводКодаАктивации=OptionEnterActivationCode
ВариантВыборОО=OptionOoSelection
ВариантДанных=DataVariant
ВариантДанныхДляОбработкиСУчетомРазделения=VariantOfDataForProcessingTakingIntoAccountSeparation
ВариантЗапросНаРегистрацию=OptionRequestForRegistration
ВариантОтчетаПоСсылкеИКлючу=VersionOfReportByLinkAndKey
ВариантСинхронизацииДокументовВручнуюПриИзменении=OptionToSynchronizeDocumentsManuallyWhenChanging
ВариантСинхронизацииДокументовОтправлятьАвтоматическиПриИзменении=OptionToSyncDocumentsSendAutomaticallyWhenChanges
ВариантСинхронизацииДокументовОтправлятьПолучатьАвтоматическиПриИзменении=OptionToSyncDocumentsSendReceiveAutomaticallyWhenChanges
ВариантСинхронизацииДокументовПолучатьАвтоматическиПриИзменении=OptionToSyncDocumentsReceiveAutomaticallyWhenChanges
ВариантСинхронизацииСправочниковАвтоматическиПриИзменении=OptionToSyncCatalogsAutomaticallyWhenYouChange
ВариантСинхронизацииСправочниковВручнуюПриИзменении=OptionToSynchronizeCatalogsManuallyWhenChanging
ВариантСинхронизацииСправочниковТолькоИспользуемуюВДокументахПриИзменении=OptionToSynchronizeCatalogsOnlyUsedInDocumentsWhenChanging
ВариантСОграничениямиДоступа=VariantWithRestrictedAccess
ВариантЦвета=ColorOption
ВариантыАдреса=AddressOptions
ВариантыОтчетов_ПроверитьПодключениеКХранилищуВариантов=ReportOptions_CheckConnectionToOptionsStore
ВвестиКодНаСервере=EnterCodeOnServer
ВвестиКодРегистрацииНаСервере=EnterRegistrationCodeOnServer
ВерсииДругойПрограммы=VersionsOfAnotherProgram
ВерсииКоманднаяПанель=VersionsCommandBar
ВерсииОбластейКоманднаяПанель=VersionsOfCommandPanelAreas
ВерсииОбластейПриИзменении=VersionsOfAreasWhenChanged
ВерсииОбластейСостояниеПросмотра=VersionsOfTheViewStateAreas
ВерсииОбластейСтрокаПоиска=VersionsOfTheSearchBarAreas
ВерсииОбластейУправлениеПоиском=VersionsOfTheSearchManagementAreas
ВерсииПодсистемНаНачалоОбновления=SubsystemVersionsAtStartUpdates
ВерсииУстановлены=VersionsInstalled
ВерсииЭтойПрограммы=VersionsOfThisProgram
ВерсияExtAPI=EXTAPIVersion
ВерсияExtAPIМенеджераСервиса=ServiceManagerExtAPIVersion
ВерсияОбработкиНаСервере=VersionOfProcessingOnServer
ВерсияПодсистемыНаНачалоОбновления=SubsystemVersionAtStartUpdates
ВерсияПолучить=VersionGet
ВерсияПриЗапуске=VersionOnStartup
ВерсияРасширения=ExtensionVersion
ВерсияРасширенияБиблиотеки=LibraryExtensionVersion
ВерхОбласти=TopOfArea
ВеткаОсновногоОбработчика=MainProcessorBranch
ВзаимодействиеXDTO=XdtoInteraction
Вид\ анализа=TypeOfAnalysis
ВидАдресЭлектроннойПочты=ViewEmailAddress
ВидГран=TypeOfGran
ВидДоступаДляТаблицСОтключеннымИспользованием=AccessTypeForTablesWithDisabledUse
ВидДоступаПравоДобавлениеБезОграничения=AccessTypeRightAdditionWithoutRestriction
ВидДоступаПравоИзменениеБезОграничения=AccessTypeRightChangeWithoutRestriction
ВидДоступаПравоИнтерактивноеДобавление=AccessTypeRightInteractiveAdd
ВидДоступаПравоИнтерактивноеДобавлениеРасшифровка=AccessTypeRightInteractiveAddingDecoding
ВидДоступаПравоПросмотр=AccessTypeRightView
ВидДоступаПравоПросмотрРасшифровка=AccessViewRightViewDecoding
ВидДоступаПравоРедактирование=AccessTypeRightEditing
ВидДоступаПравоРедактированиеРасшифровка=AccessTypeRightEditingDecryption
ВидДоступаПравоЧтениеБезОграничения=AccessTypeRightReadUnlimited
ВидимостьКолонкиНаСервере=VisibilityColumnsOnServer
ВидимостьПроверкиНаСервере=VisibilityCheckOnServer
ВидимостьСостоянияСертификатаПослеПолученияСертификатовВЛичномХранилище=VisibilityCertificateStatusAfterGettingCertificatesInPersonalStorage
ВидНоменклатурыПриИзменении=ProductKindOnChange
ВидПодписки=SubscriptionKind
ВидПоУмолчанию=DefaultView_
ВидыДокументовКоманднаяПанель=DocumentsKindsCommandBar
ВидыДокументовСостояниеПросмотра=DocumentsKindsViewStatus
ВидыДокументовСтрокаПоиска=DocumentsKindsSearchString
ВидыДокументовУправлениеПоиском=DocumentsKindsSearchControl
ВидыДоступаВедущихТаблиц=AccessTypesLeadingTables
ВидыДоступаВложеннойВедущейТаблицы=AccessTypesNestedMasterTable
ВидыДоступаСПредставлением=AccessTypesWithView
ВидыОграниченийПравБезусловные=TypesRestrictionsPermissionsUnconditional
ВидыОграниченийПравДляВнешнихПользователей=TypesRestrictionsPermissionsForExternalUsers
ВидыОграниченийПравДляВнешнихПользователейСтрокой=TypesRestrictionsPermissionsForExternalUsersString
ВидыОграниченийПравДляПользователей=TypesRestrictionsPermissionsForUsers
ВидыОграниченийПравДляПользователейСтрокой=TypesRestrictionsPermissionsForUsersString
ВидыОграниченийПравИсходные=TypesRestrictionsRightsInitial
ВидыОграниченийПравПреобразованные=RightsRestrictionTypesTransformed
ВидыОграниченийПравСтрокой=KindsRestrictionsPermissionsString
ВидыОграниченийСтрокой=ConstraintTypesString
ВидыСубконтоКоманднаяПанель=ExtDimensionTypesCommandBar
ВключатьЗаголовки=IncludeHeadings
ВключаяКонфигурацию=IncludingConfiguration
ВключитьАвтоматическуюЗагрузкуИсправлений=EnableAutomaticDownloadOfFixes
ВключитьБезусловно=EnableDefinitely
ВключитьВидимостьСостоянияСертификата=EnableCertificateStatusVisibility
ВключитьЗаполнениеПараметровРаботыРасширений=EnableFillingExtensionsWorkParameters
ВключитьИспользованиеАвторизацииSMTP=EnableUseAuthorizationSMTP
ВключитьИспользованиеЦентраМониторинга=EnableTheUseOfTheMonitoringCenter
ВключитьОтключитьОтложенноеОбновление=EnableDisableDeferredUpdate
ВключитьПараметр=EnableParameter
ВключитьПодробноеПредставлениеОшибки=EnableVerboseRepresentationErrors
ВладелецБезопасногоХранилища=OwnerOfSecureStorage
ВладелецИлиПользовательНастроек=OwnerOrUserSettings
ВладелецИлиПользовательНастроекПредставление=OwnerOrUserSettingsView
ВладелецНастроек=SettingsOwner
ВладелецНастроекЗаголовок=OwnerSettingsHeader
ВладелецОбъекта=ObjectOfOwner
ВладелецПароляАвторизацииВСервисе=OwnerOfAuthorizationPasswordInService
ВладелецПароляАвторизацииВУчетнойСистеме=OwnerOfAuthorizationPasswordInAccountSystem
ВладелецПоля=FieldOwner
ВладельцыМакетов=LayoutOwners
ВложенияBase64=Base64Attachments
ВложеннаяСхема=NestedSchema
ВложенноеСобытие=NestedEvent
ВложенностьДляОбластей=NestingForAreas
ВнутренняяНавигационнаяСсылка=InternalNavigationLink
ВнутригородскойРайон=CityDistrict
ВозвратФайла=ReturnFile
Возвращаемое=Return
ВозможенПеревыпуск=PossibleReissue
ВозможноПродолжениеПроцедурыЗагрузки=ItIsPossibleToContinueLoadingProcedure
ВозможныеПраваСеанса=PossibleSessionRights
ВопросОПрерваннойЗагрузкеЗавершение=QuestionAboutInterruptedDownloadCompletion
ВопросОСнятииПометокСАвтоматическиОтмеченныхПодсистем=QuestionOfUncheckingAutomaticallyMarkedSubsystems
ВосстанавливаемоеРасширение=RecoverableExtension
ВосстановитьНесуществующиеВидыИЗначенияДоступа=RestoreNonexistentViewsFromAccessValue
ВосстановитьРасширения=RestoreExtensions
ВосстановлениеЗначенияДата=RestoringDateValue
ВременнаяОчередь=TempQueue
ВременнаяОчередьОбъект=TempQueueObject
ВременныеОчереди=TempQueues
ВременныйФайлЧастиКода=TemporaryFileOfPieceOfCode
ВремКаталог=TimeCatalog
ВремОбъект=TimeObject
ВремяЗапроса=RequestTime
ВремяОжиданияФоновогоЗадания=WaitingTimeForABackgroundTask
ВремяФормированияОтчета=ReportGenerationTime
ВсеБизнесПроцессы=AllBusinessProcesses
ВсеВнешниеИсточникиДанных=AllExternalDataSources
ВсеЖурналыДокументов=AllDocumentLogs
ВсеМакеты=AllMakets
ВсеМультиязычныеРеквизиты=AllMultilingualRequisites
ВсеНаборыЗаписейПерерасчета=AllRecordSetsAreRecalculated
ВсеНаборыЗаписейПоследовательности=AllSetsOfSequenceRecords
ВсеНезависимыеНаборыЗаписей=AllIndependentRecordSets
ВсеНовыеПодсистемы=AllNewSubsystems
ВсеОбласти=AllAreas
ВсеОбщиеРеквизиты=AllGeneralDetails
ВсеПараметрыСеанса=AllSessionParameters
ВсеПеречисления=AllEnumerations
ВсеПланыВидовРасчета=AllPlansTypesOfCalculation
ВсеПланыОбмена=AllExchangePlans
ВсеПланыСчетов=AllAccountPlans
ВсеПрописные=AllCaps
ВсеРасширенияПодключены=AllExtensionsConnected
ВсеРегистрыБухгалтерии=AllAccountingRegisters
ВсеРегистрыНакопления=AllAccumulationRegisters
ВсеРегистрыРасчета=AllCalculationRegisters
ВсеРегистрыСведений=AllInformationRegisters
ВсеРегламентныеЗадания=AllRoutineTasks
ВсеСсылочныеДанныеПоддерживающиеПредопределенныеЭлементы=AllReferenceDataSupportingPredefinedElements
ВсеСтрочные=AllLiners
ВсеШаблоны=AllTemplates
ВсеШаблоныСозданы=AllTemplatesCreated
ВторойДополнительныйЯзыкИзменен=SecondAdditionalLanguageChanged
ВторойОбработчик=SecondHandler
ВходВСервис=LogInToService
ВходнойТекст=InputText
ВходныеДанные=InputData
ВхожденияСтроки=OccurrencesOfString
ВыбираемыйФайл=SelectedFile_
ВыборкаПоЗаписям=SelectionByRecords
ВыборкаПользователь=SampleUser
ВыборкаПоРегистраторам=SamplingByRegistrars
ВыборкаПрофилей=ProfileSelectionig
ВыборкаРезультат=SamplingResult
ВыборкаСсылка=FetchLink
ВыборОрганизацииЗавершение=ChoosingOrganizationCompletion
ВыборПереопределен=ChoiceOverride
ВыборПользователяИБ=ChoosingInformationSecurityUser
ВыбраннаяСсылка=SelectedLink
ВыбранныеИнтервалы=SelectedIntervals
ВыбранныеОМД=SelectedOMD
ВыбранныеПодразделения=SelectedDivisions
ВыбранныеПрава=SelectedPermissions
ВыбранныеПрофили=SelectedProfiles
ВыбранныеРоли=SelectedRoles
ВыбранныеСклады=SelectedWarehouses
ВыбранныеУровни=SelectedLevels
ВыбранныйИнтервал=SelectedInterval
ВыбранныйОбработчик=SelectedHandler
ВыбратьАбонента=SelectSubscriber
ВыбратьПользователейПослеВыбораТипа=SelectUsersAfterSelectionType
ВыбратьФайлПослеОшибкиПолученияКонтейнераПодписи=SelectFileAfterReceivingSignatureContainerError
ВыбратьФайлПослеПолученияКонтейнераПодписи=SelectFileAfterGettingContainerSignature
ВыведеноРисунков=DrawnDrawings
ВывестиОшибкиВТекстовыйФайл=OutputErrorsToTextFile
ВыводитьОбласть=OutputRegion
ВыгружаемыеТипыОбщихДанных=UnloadedTypesOfSharedData
ВыгружаемыйТип=UnloadedType
ВыгружатьДанные=UploadData
ВыгружатьДанныеРасширений=UploadExtensionData
ВыгружатьСообщениеПослеПерехода=UploadMessageAfterTransition
ВыгружатьТекстыRLSПриИзменении=UploadRLSTextsWhenChangesAreMade
ВыгружатьФайлыВКаталогПриИзменении=UploadFilesToDirectoryWhenChangesAreMade
ВыгрузитьВерсииПодсистем=UnloadSubsystemVersions
ВыгрузитьВТом=UploadTo
ВыгрузитьГраницыПоследовательности=UnloadSequenceBoundaries_
ВыгрузитьДанныеРасширений=UploadExtensionData_
ВыгрузитьДанныеТекущейОбластиВАрхив=UploadCurAreaDataToArchive
ВыгрузитьДифференциальнуюКопию=UnloadDifferentialCopy
ВыгрузитьОбъектМетаданных=UploadMetadataObject
ВыгрузитьПланыОбмена=UnloadExchangePlans
ВыгрузитьСправочникПользователи=UploadUsersCatalog
ВыгрузитьСхемуКонфигурации=UnloadConfigurationDiagram
ВыгрузитьТекущуюОбластьВАрхив=UploadCurAreaToArchive
ВыгрузитьТекущуюОбластьДанныхВТом=UnloadCurDataAreaInVolume
Выгрузка=Upload0
ВыгрузкаВТранзакцииВыполнена=UnloadingInTransactionIsCompleted
ВыгрузкаДифференциальнойКопииВозможна=UnloadingDifferentialCopyIsPossible
ВыгрузкаЗагрузкаДанныхЗагрузкаПрервана=UnloadingLoadingDataLoadingAborted
ВыгрузкаНаКлиентеИлиНаСервереПриИзменении=UploadingToClientOrServerWhenChangesAreMade
ВыгрузкаНеДоступна=UploadIsNotAvailable
ВыгрузкаПоРасписанию=ScheduledUpload
ВыгрузкаСовместима=UnloadingIsCompatible
ВыделеноНесколькоСтрок=SeveralLinesAreHighlighted
ВызватьИсключениеКонтроля=ThrowControlException
ВызватьИсключениеОтсутствуетРасширениеБТС=CauseExceptionMissingBTSExtension
ВыключитьПараметр=DisableOption
ВыключитьСвойствоИБ=DisablePropertyIB
ВыполнитьЗаданиеСРасширениями=CompleteTaskWithExtensions
ВыполнитьМетодВнешнегоИнтерфейса=ExecuteExternalInterfaceMethod
ВыполнитьМногопоточныйПроцесс=ExecuteMultithreadedProcess
ВыполнитьНаСторонеПослеУсовершенствованияИПроверкиСертификата=ExecuteOnSideAfterImprovementAndCertificateVerification
ВыполнитьНаСторонеЦиклПослеОшибкиПолученияКонтейнераПодписиНаКлиенте=RunOnSideLoopAfterErrorGettingContainerSignaturesOnClient
ВыполнитьНаСторонеЦиклПослеУсовершенствования=RunOnSideLoopAfterImprove
ВыполнитьОбновлениеНеразделенныхДанныхВФоне=ExecuteUpdateUnsharedDataInBackground
ВыполнитьОбновлениеРазделенныхДанныхВФоне=ExecuteUpdateSplitDataInBackground
ВыполнитьОбработкуДанныхРегламентнымЗаданием=ExecuteDataProcessingRegularTask
ВыполнитьПакетныйЗапуск=PerformABatchLaunch
ВыполнитьПереносЗавершение=ExecuteTransferFinish
ВыполнитьПереносФайлов=ExecuteFileTransfer
ВыполнитьПереходНаСинхронизациюДанныхЧерезУниверсальныйФормат=SwitchToDataSynchronizationViaUniversalFormat
ВыполнитьПереходПоАдресу=ExecuteNavigationByAddress
ВыполнитьПослеПолученияКонтейнераПодписи=ExecuteAfterGettingContainerSignatures
ВыполнитьПослеПолученияКонтейнераУсовершенствованнойПодписи=ExecuteAfterGettingEnhancedSignatureContainer
ВыполнитьПроцедуруВНесколькоПотоков=ExecuteProcedureinMultipleThreads
ВыполнитьРасчетРазмераПриложения=RunCalculationApplicationSize
ВыполнитьРегистрациюИзменений=PerformChangeRegistration
ВыполнитьФункциюВНесколькоПотоков=ExecuteFunctionInMultipleThreads
выполнялся=Performed
ВыполнятьВыгрузкуВоВременнуюПапкуПриИзменении=UploadToTemporaryFolderWhenChangesAreMade
ВыполнятьЗапись=PerformRecording_
ВыполнятьПроверкуУдостоверяющегоЦентра=PerformCAVerification
ВыражениеXPathБазовоеСвойствоРоли=ExpressionXPathBasicPropertyOfRole
ВыражениеСодержитАгрегатнуюФункцию=ExpressionContainsAggregateFunction
ВычисленноеЗначение=ComputedValue
ВычислитьКоличество=CalculateQuantity
ВыявитьИИсправитьУстаревшиеАдреса=DetectFixObsoleteAddresses
ГигабайтДо=GigabyteTo
ГиперссылкаВКавычках=HyperlinkInQuotes
ГиперссылкаПроблемСДанными=HyperlinkProblemsWithData
ГиперссылкаПроблемСОбработчиками=HyperlinkProblemsWithHandlers
Государственный=IsState
ГотовоНаСервере=DoneOnServer
ГраницаЗаголовкаРаздела=SectionHeaderBorder
ГраницаСтекаНастроек=StackBorderSettings
ГруппаДобавлятьМеткиАвтоматически=GroupAddLabelsAutomatically
ГруппаДокумент=GroupDocument
ГруппаДоступаРасшифровка=AccessGroupDecryption
ГруппаКоличествоВалюта=GroupQuantityCurrency
ГруппаКонтента=GroupWithContent
ГруппаМакетов=LayoutGroup
ГруппаПоиск=GroupSearch
ГруппаСвернута=GroupCollapsed
ГруппаСубконто=ExtDimensionGroup
ГруппаФайла=FileGroup_
ГруппировкаПоНомеруСтроки=GroupingByLineNumber
ГруппировкаПоСсылке=GroupingByReference
ГруппыМакетов=LayoutGroups
ДанныеАвторизацииВСервисе=AuthorizationDataInService
ДанныеАвторизацииВСлужбеПоддержки=AuthorizationDataInSupportService
ДанныеБанковскогоСчета=BankAccountData
ДанныеВосстанавливаемогоРасширения=DataOfRestoredExtension
ДанныеДляУправленияПриИзменении=DataToManageOnChange
ДанныеДляХеширования=DataForHashing
ДанныеЗапросаСозданияИзмененияСчетаНаОплату=RequestDataForCreatingAndModifyingInvoiceForPayment
ДанныеЗапросаСчетаНаОплату=InvoiceRequestData
ДанныеИсточников=SourceData_
ДанныеИсточниковСгруппированыПоВладельцуИсточникаДанных=SourceDataGroupedByDataSourceOwner
ДанныеКлассификаторовКоманднаяПанель=ClassifiersDataCommandPanel
ДанныеКлассификаторовПередНачаломДобавления=ClassifierDataBeforeAdding
ДанныеКлассификаторовПередУдалением=ClassifiersDataBeforeDeletion
ДанныеКлассификаторовСостояниеПросмотра=ClassifierDataViewStatus
ДанныеКлассификаторовСтрокаПоиска=ClassifierDataSearchString
ДанныеКлассификаторовУправлениеПоиском=ClassifierDataSearchManagement
ДанныеНастроек=SettingsData
ДанныеНастроекИнтеграцииСУСП=DataForSuspIntegrationSettings
ДанныеОбОшибке=ErrorData
ДанныеПериода=PeriodData
ДанныеПечатиМультиязычныеРеквизиты=DataPrintMultilingualRequisites
ДанныеПечатиРисунковТабличногоДокумента=DataPrintPatternPatternDocument
ДанныеПечатиСуммаПрописью=DataPrintAmountWords
ДанныеПечатиФамилияИнициалы=DataPrintLastNameInitials
ДанныеПоВзаимодействию=InteractionData
ДанныеПодписки=SubscriptionData_
ДанныеПоля=FieldData
ДанныеПоОбращению=DataByIncident
ДанныеПоПереписке=CorrespondenceData
ДанныеПредупреждения=DataWarnings
ДанныеРасширенияТарифа=TariffExtensionData
ДанныеСхемыКонфигурации=ConfigurationSchemaData
ДанныеСчета=InvoiceData
ДанныеСчетаНаОплату=CustomerInvoiceDetails
ДанныеТокена=TokenData
ДанныеУдостоверяющегоЦентра=CertificationAuthorityData
ДанныеФайлаПользовательскогоРасширения=UserExtensionFileData
ДанныеЭлемента=ElementData
ДанныеЯзыка=LanguageData
ДанныхПоставляемогоРасширенияДостаточноДляРезервногоКопирования=DataOfSuppliedExtensionIsSufficientForBackup
ДатаАктуальности=UpdateDate
ДатаИстеченияДоступа=AccessExpirationDate
ДатаКурса=DateOfCourse
ДатаНачалаСеансаОбновления=UpdateSessionStartDate
ДатаОтбораЗагрузкиПисемПоПротоколуIMAP=DateOfSelectionOfIMAPMessageUpload
ДатаПодписиИзМетки=DateSignedFromLabels
ДатаПодписиИзПараметровПодписи=DateSignatureFromSignatureParameters
ДатаПолученияСертификата=DateCertificateReceived
ДатаПоследнегоИзмененияСтрока=DateLastModifiedString
ДатаПоследнегоИзмененияФайла=FileLastModifiedDate
ДатаПоследнейМеткиВремени=DateLastTimestamp
ДатаПроверкиОбновления=DateChecksUpdates
ДатаСведений=DateOfLastEdit
ДатыЗапретаНовый=BanDatesNew
ДатыРабочихДнейКоманднаяПанель=DatesOfWorkingDaysCommandPanel
ДатыСведений=DatesDetails
ДВ=DV
Движения_ДемоОстаткиТоваровВМестахХраненияКоманднаяПанель=Movements_DemoBalanceOfGoodsInStorageLocationsCommandPanel
Движения_ДемоОстаткиТоваровВМестахХраненияПриНачалеРедактирования=MovementsOfDemoRemnantsOfGoodsInStoragePlacesAtTheBeginningOfEditing
Движения_ДемоОстаткиТоваровВМестахХраненияСостояниеПросмотра=MovementsDemoRemnantsOfGoodsInStorageLocationsViewingStatus
Движения_ДемоОстаткиТоваровВМестахХраненияСтрокаПоиска=MovementsDemoRemnantsOfGoodsInStorageLocationsSearchBar
Движения_ДемоОстаткиТоваровВМестахХраненияУправлениеПоиском=MovementsDemoRemnantsOfGoodsInStorageLocationsSearchManagement
ДвоичныеДанныеСхемыТекущейКонфигурации=BinarySchemaDataOfCurConfiguration
ДействиеОбработкиРасшифровки=ActionProcessingDecoding
ДействиеСоСсылками=ActionWithLinks
ДействиеСоСсылкамиНеВыгружатьОбъект=ActionWithLinksDoNotUnloadObject
ДействиеСоСсылкамиНеИзменять=ActionWithLinksDoNotChange
ДействиеСоСсылкамиОчищать=ActionWithClearLinks
ДействияПриОбнаруженииСсылок=ActionsWhenLinksAreDetected
ДействияПриОбнаруженииСсылокНаТипыИсключаемыеИзВыгрузки=ActionsWhenFindingReferencesToTypesExcludedFromUnloading
Декорация1=Decoration1
ДекорацияВосстановлениеНажатие=DecorationRestorationPressing
ДекорацияВсеИдентификаторыНажатие=DecorationAllIdsClick
ДекорацияЗагрузкаИсправленийРасписаниеНажатие=DecorationLoadingFixesSchedulePressing
ДекорацияЗарегистрироватьсяНаПортале1СИТСНажатие=DecorationRegisterOnThePortal1CITSClick
ДекорацияИнформацияУстановкаЗавершенаОбработкаНавигационнойСсылки=DecorationInformationInstallationCompletedProcessingOfNavigationLink
ДекорацияКартинка=PictureDecoration
ДекорацияНаписатьВТехПоддержкуОбработкаНавигационнойСсылки=DecorationIsToWriteToTechnicalSupportProcessingNavigationLink
ДекорацияОбработкаЗапросовЗаголовокОбработкаНавигационнойСсылки=QueriesProcessingHeaderDecorationURLProcessing
ДекорацияОписаниеРезультатаОбработкаНавигационнойСсылки=DecorationDescriptionOfResultProcessingOfNavigationLink
ДекорацияОткрытьЖурналРегистрацииОбработкаНавигационнойСсылки=DecorationOpenLogProcessingNavigationLink
ДекорацияОшибкаОбработкаНавигационнойСсылки=ErrorDecorationURLProcessing
ДекорацияПатчиИсправляемыеОшибкиНажатие=DecorationPatchesCorrectableErrorsPressing
ДекорацияРасписаниеЗаданияНажатие=DecorationTaskScheduleClick
ДекорацияРегистрацияНажатие=DecorationRegistrationPressing
ДекорацияРекомендацииПриОшибкеОбработкаНавигационнойСсылки=DecoratingRecommendationsForErrorHandlingNavigationLinks
ДекорацияРешениеОбработкаНавигационнойСсылки=DecorationDecisionURLProcessing
ДекорацияСообщениеОбОшибкеПолученияОбновленияОбработкаНавигационнойСсылки=DecorationErrorMessageAboutReceivingUpdateProcessingNavigationLink
ДекорацияСообщениеСервисаОбработкаНавигационнойСсылки=DecorationServiceMessageNavigationLinkProcessing
ДекорацияСтраницаПодтверждениеРегистрации=DecorationRegistrationConfirmationPage
ДекорацияСтрЗавершеноНеСоздаватьРК=DecorationPageCompletedDoNotCreateRC
ДекорацияСтрЗавершеноСоздатьРК=DecorationPageCompletedCreateRC
ДекорацияСтрУстановленаНеСоздаватьРК=TheDecorationOfThePageIsSetNotToCreateRC
ДекорацияСтрУстановленаСоздатьРК=TheDecorationOfThePageIsSetToCreateARC
ДекорацияУстановитьОбновлениеИзФайлаНажатие=DecorationInstallUpdateFromFilePressing
ДеревоМетаданныхВыгружатьПриИзменении=UploadMetadataTreeWhenChangesAreMade
ДеревоМетаданныхВыгружатьПриНеобходимостиПриИзменении=UnloadMetadataTreeIfNecessaryWhenChanging
ДеревоМетаданныхПересчитатьВыгружаемыеПоСсылке=MetadataTreeRecalculateUploadedByLink
ДеревоОбъектовДеревоОбъектовСнятьПометку=ObjectTreeObjectTreeUncheck
ДеревоОбъектовДеревоОбъектовУстановитьПометку=ObjectTreeObjectTreeSetAMark
ДеревоОбъектовКоманднаяПанель=ObjectsTreeCommandBar
ДеревоОбъектовОбъект=ObjectsTreeObject
ДеревоПланаВыполненияЗапросаКоманднаяПанель=QueryExecutionPlanTreeCommandPanel
ДеревоПланаВыполненияЗапросаСостояниеПросмотра=QueryExecutionPlanTreeViewStatus
ДеревоПланаВыполненияЗапросаСтрокаПоиска=QueryExecutionPlanTreeSearchString
ДеревоПланаВыполненияЗапросаУправлениеПоиском=QueryExecutionPlanTreeSearchManagement
ДеревоПолейДанныхПечати=PrintDataFieldTree
Детали=Details_3
ДифференциальныйАрхив=DifferentialArchive
ДляОбновления=ForUpdate
ДляОбслуживающейОрганизации=ForServiceOrganization
ДляОткрытия=ToOpen
ДляПодпапок=ForSubfolders
ДляПроверкиПодписи=ToVerifySignature
ДляСохранения=ForSave
ДляТехПоддержки=ForThoseSupport
ДМ=DM
ДобавитьВидДоступаВедущейТаблицы=AddAccessTypeHostTable
ДобавитьВидыОграниченияПрав=AddViewsRestrictionsRights
ДобавитьВИерархию=AddWIerarchy
ДобавитьВнешниеФайлы=AddExternalFiles
ДобавитьДелоНекорректныеСведенияОПользователях=AddCaseInvalidUsersInfo
ДобавитьДополнительноеПоле=AddAdditionalField
ДобавитьДополнительныеСведения=AddAdditionalDetails
ДобавитьДочерниеОбработчики=AddChildHandlers
ДобавитьЗаголовкиДанных=AddDataHeaders
ДобавитьЗначениеВСписокXDTO=AddValueToXDTOList
ДобавитьИнформациюОбОшибкеВОбработчике=AddErrorInformationInHandler
ДобавитьИнформациюОПриложении=AddAppInformation
ДобавитьИспользованныйПароль=AddUsedPassword
ДобавитьКДате=AddToDate
ДобавитьКоллекцииОбъектовМетаданныхСПравами=AddMetadataObjectCollectionWithRights
ДобавитьКомандуПереходаМеждуИзменениямиНастроек=AddTransitionCommandBetweenSettingChanges
ДобавитьКомандыИПоля=AddCommandsFields
ДобавитьКонтактПочта=AddContactMail
ДобавитьКонтактТелефон=AddContactPhone
ДобавитьЛегенду=AddLegend
ДобавитьНастройкиВСтек=AddSettingstoStack
ДобавитьОписаниеНазначения=AddDescriptionOfDestination
ДобавитьОписаниеНачальногоЗаполненияПрофиляНаВстроенномЯзыке=AddDescriptionOfInitialFillingOfProfileInBuiltInLanguage
ДобавитьОписаниеПоставляемогоПрофиля=AddDescriptionOfSuppliedProfile
ДобавитьОписаниеРолейИВидовДоступа=AddDescriptionOfRolesAndAccessTypes
ДобавитьПКО_Справочник_КодТНВЭД_Из_Структуры=AddThePKODirectoryHSCodeFromTheStructure
ДобавитьПКО_Справочник_НомерГТД_Из_Структуры=AddThePKOReferenceNumberOfTheGTDFromTheStructure
ДобавитьПКО_СправочникСсылка_СтраныМира_Отправка=AddPKODirectoryLinkCountriesOfTheWorldSending
ДобавитьПОД_Справочник_КодТНВЭД_Из_Структуры=AddTheHSCodeFromTheStructureUnderTheDirectory
ДобавитьПОД_Справочник_НомерГТД_Из_Структуры=AddTheGTDNumberFromTheStructureUnderTheDirectory
ДобавитьПоток=AddStream
ДобавитьПрава=AddRights
ДобавитьПраваИнтерактивнойРаботыСОбъектами=AddPermissionsInteractiveWorkWithObjects
ДобавитьПраваПрограммнойРаботыСОбъектами=AddPermissionsProgrammingWorkWithObjects
ДобавитьПраваРаботыСИсторией=AddJobPermissionsWithHistory
ДобавитьПраваРаботыСПредопределеннымиДанными=AddJobPermissionsWithPredefinedData
ДобавитьПраваРолиПрофилей=AddPermissionsProfileRoles
ДобавитьПраво=SetRight
ДобавитьРазделыПоискаПоПодсистемам=AddSearchSectionsBySubsystems
ДобавитьРазрешениеДляИнтернетРесурса=AddPermissionForInternetResource
ДобавитьСертификатыВЛичномХранилищеВПараметрДинамическогоСписка=AddCertificatesInPersonalVaultDynamicListParameter
ДобавитьСписки_00_00463430=AddLists_00_00463430
ДобавитьТаблицыСОтключеннымОграничением=AddTablesWithRestrictionDisabled
ДобавитьТипПодписи=AddSignatureType
ДобавитьЭлементОтбораОбработчикаРасшифровки=AddDecryptionHandlerSelectionElement
ДобавитьЭлементыОписанияОшибок=AddItemsDescriptionsErrors
ДобавитьЭлементыРаздела=AddSectionItems
ДобавитьЯзык=AddLanguage
добавленной=OfAdded
ДобавленныйЭлемент=AddedElement
ДобавлятьЗаголовок=AddTitle_
ДоговорПриИзменении=ContractOnChange
Документ_ДемоПеремещениеТоваров=DocumentDemoMovementOfGoods
Документ_ДемоПоступлениеТоваров=DocumentDemoReceiptOfGoods
Документ_ДемоРеализацияТоваров=DocumentDemoSaleOfGoods
Документ_ДемоСчетФактураПолученный=DocumentDemoInvoiceReceived
документа=Document_
ДокументВид=DocumentView
ДокументВозврата=DocumentReturnPolicy
ДокументОплаты=DocumentPayments
ДопИнфо=AddlInfo
ДополнительнаяПроверкаНаВозможностьПодписания=AdditionalCheckOnthePossibilityofSigning
ДополнительнаяПроверкаСертификата=AdditionalVerificationCertificate
ДополнительнаяСтрокаИерархии=ExtraStringHierarchy
ДополнительныеДанныеДляКлассификатораОшибок=AdditionalDataForErrorClassifier
ДополнительныеДанныеОшибки=AdditionalErrorData
ДополнительныеДанныеПроверки=AdditionalDataChecks
ДополнительныеДанныеПроверкиНаКлиенте=AdditionalDataChecksAtClient
ДополнительныеДанныеПроверкиНаСервере=AdditionalDataChecksAtServer
ДополнительныеДанныеПроверок=Additional_DataChecks
ДополнительныеДанныеПроверокНаКлиенте=AdditionalDataChecksOnClient
ДополнительныеДанныеПроверокНаСервере=AdditionalDataChecksOnServer
ДополнительныеОбъектыДляВыгрузкиДобавить=AddAdditionalObjectsToUpload
ДополнительныеОбъектыДляВыгрузкиДобавитьИзЗапроса=AddAdditionalObjectsToUploadFromTheRequest
ДополнительныеОбъектыДляВыгрузкиКоманднаяПанель=AdditionalObjectsToUploadCommandPanel
ДополнительныеОбъектыДляВыгрузкиНастройкиКонсолиЗапросов=AdditionalObjectsForUploadingQueryConsoleSettings
ДополнительныеОбъектыДляВыгрузкиОчиститьДополнительныеОбъектыВыгрузки=AdditionalObjectsToUnloadClearAdditionalObjectsToUnload
ДополнительныеОбъектыДляВыгрузкиПередНачаломДобавления=AdditionalObjectsToUploadBeforeAdding
ДополнительныеОбъектыДляВыгрузкиПриИзменении=AdditionalObjectsToUploadWhenChangesAreMade
ДополнительныеОбъектыДляВыгрузкиСостояниеПросмотра=AdditionalObjectsToUploadViewState
ДополнительныеОбъектыДляВыгрузкиСтрокаПоиска=AdditionalObjectsToUploadSearchString
ДополнительныеОбъектыДляВыгрузкиУправлениеПоиском=AdditionalObjectsToUploadSearchManagement
ДополнительныеПараметрыПроверкиСертификата=AdditionalCertificateVerificationParameters
ДополнительныеПараметрыПроверок=AdditionalInspectionParameters
ДополнительныеСимволы=AdditionalChars
ДополнительныеЯзыки=AdditionalLanguages
ДополнительныйЗаголовокТаблицы=OptionalTableTitle
ДополнительныйУзел=AdditionalNode
ДополнитьОписаниеМакета=AddDescriptionLayout
ДополнитьОтборОбработчикаРасшифровки=AddSelectionHandlerDecryption
ДополнитьСписокМакетов=PadListLayouts
ДополнитьСписокНеСопоставленнымиПользователями=AddUnmappedUsersToList
ДополнитьСписокСертификатовВЛичномХранилищеНаСервере=AddListofCertificatesInPersonalStorageOnServer
ДополнитьТипомИсключаемымИзВыгрузкиЗагрузки=AddTypeExcludedFromUploadingUploads
ДополнитьТипы=AddTypes_
ДопРеквизиты=AddAttributes
ДопСведения=AdditionalInformation_2
ДопСведенияОбслуживаемогоАбонента=AdditionalInformationOfServedSubscriber
ДопустимаяКоллекция=ValidCollection
ДопустимоеВремяДляАвтоформированияОтчета=AllowableTimeForReportAutoGeneration
ДопустимоеКоличествоПотоков=AllowedNumberofThreads
ДопустимыеКоллекции=ValidCollections
ДоставитьОповещения=DeliverAlerts
ДоставляемоеОповещение=DeliveredNotification
ДоставляемыеОповещения=DeliveredAlerts
ДоступенПереводМакета=AvailableTranslationLayout
ДоступенРасчет=CalculationAvailable
ДоступенРасчетПриложения=AppCalculationIsAvailable
ДоступнаАвтоматическаяЗагрузкаИсправлений=AutomaticDownloadOfFixesIsAvailable
ДоступнаАвторизацияПоКоду=AvailableAuthorizationByCode
ДоступнаЗагрузкаИсправлений=PatchDownloadsAreAvailable
ДоступнаИнтеграцияСЦентромМониторинга=IntegrationWithTheMonitoringCenterIsAvailable
ДоступнаПроверкаПоСпискуУЦ=AvailableCheckAccordingtoCAList
ДоступноДобавлениеМакетов=AddingTemplatesIsAvailable
ДоступноеПолеОтбораПоЗаголовку=AvailableFilterFieldByTitle
ДоступноИспользованиеСервиса1СТакском=YouCanUse1CTaxiService
ДоступноСоздание=AvailableCreate
ДоступностьClientManagedApplication=ClientManagedApplicationAvailability
ДоступностьНастроекУсовершенствованияПодписи=AvailabilitySettingsImprovementsSignatures
ДоступностьФлагаХранитьИсториюИзменений=FlagAvailabilityKeepHistoryChanges
ДоступныеВерсииФормата=AvailableFormatVersions
ДоступныеДляПереводаМакеты=AvailableforTranslationLayouts
ДоступныеДляРедактирования=AvailableToEdit
ДоступныеПериоды=AvailablePeriods
ДоступныеПоляОбъекта=AvailableObjectFields
ДоступныНапоминанияПользователя=UserRemindersAvailable
других=Other
ДубльПредопределенных=DoublePredefined
ДубльПредопределенныхОбъект=DuplicatePredefinedObjects
ЕстьCAdESA=IsCAdESA
ЕстьCAdESBES=IsCAdESBES
ЕстьCAdESТ=IsCAdEST
ЕстьNull=IsNull
ЕстьВосстановленные=HaveRefurbished
ЕстьВСеансе=IsInSession
ЕстьВТекущих=IsIncurrent
ЕстьВыбранныеЗависимыеПодсистемы=ThereAreSelectedDependentSubsystems
ЕстьДанныеДляФормированияОтчета=ThereIsDataForGeneratingReport
ЕстьЗависимыеПодсистемыВыбранныеПользователем=ThereAreDependentSubsystemsSelectedByUser
ЕстьЗапланированноеЗаданиеРасчетаРазмераПриложения=ThereIsScheduledJobCalculatingSizeOfApplication
ЕстьИзменяемыеОбъектыЗависимыеОтПроизводственныхКалендарей=ThereAreChangeableObjectsDependentOnProductionCalendars
ЕстьИнтервалыПрогрессаОбработкиДанных=HaveProgressIntervalsDataProcessing
ЕстьКлючеваяКолонка=IsKeyColumn
ЕстьКолонкаИмяПредопределенныхДанных=IsColumnNamePredefinedData
ЕстьКолонкаСсылка=HaveColumnLink
ЕстьКонстантаБазовойФункциональности=IsConstantBaseFunctionality
ЕстьМультиязычныеРеквизитыВШапкеОбъекта=ThereareMultilingualDetailsintheHeaderoftheObject
ЕстьНаборПрав=HaveRightSet
ЕстьНеПримененныеИсправления=ThereAreNotAppliedFixes
ЕстьОбработчикиСПараллельнымРежимомВыполнения=ThereHandlersWithParallelExecutionMode
ЕстьОграничениеПрава=YesRestrictionPermission
ЕстьОграничениеПрава2=YesRestrictionPermissions2
ЕстьОтвет=AnswerExists
ЕстьПараметрОповеститьОбОкончанииСрокаДействия=IsParameterNotifyOnExpirationofValidity
ЕстьПараметрыЗаполнения=ThereFillingParameters
ЕстьПеревыпущенные=YesReissued
ЕстьПодтверждение=ThereIsConfirmation
ЕстьПорцияДанных=HaveDataPortion
ЕстьПраваРоли=HavePermissionsRoles
ЕстьПраваЭлемента=HaveElementRights
ЕстьПравоСОграничением=YesRightWithRestriction
ЕстьПредопределенныеДанные=HavePredefinedData
ЕстьПричинаИРешение=HaveReasonAndSolution
ЕстьРазделительВЧисле=IsDelimiterInNumber
ЕстьРольВПрофиле=HasRoleInProfile
ЕстьСправочникПрисоединенныхФайлов=ThereIsADirectoryOfAttachedFiles
ЕстьСсылка=ThereIsARef
ЕстьСтраницыДо=ThereArePagesUpTo
ЕстьСтраницыПосле=ThereArePagesAfter
ЕстьТабличнаяЧасть=HaveTabularPart
ЕстьУровеньДоступа=HaveAccessLevel
ЕстьУсловие=ThereIsCondition
ЕстьУстановленныеРасширенияИзменяющиеСтруктуруДанных=ThereAreInstalledExtensionsModifyingDataStructure
ЕстьФункцияПравоДоступаИлиРольДоступнаВОграниченииЧтения=IsThereFunctionAccessRightOrRoleAvailableInReadRestriction
ЕстьЯзыковаяКолонка=HaveLanguageColumn
ЗаблокироватьВесьИнтерфейс=BlockEntireInterface
ЗаблокироватьВсеВыгружаемыеОбъекты=BlockAllUnloadedObjects
ЗаблокироватьДляИзмененияВФайловойИБ=LockForChangeInFileIB
ЗавершаетсяБесплатных=CompletedFree
ЗавершаетсяВсего=TotalCompleted
ЗавершаетсяПлатных=EndingPaid
ЗавершаетсяТестовых=TestResultsAreCompleted
ЗавершенныеВсеПоследовательныеОбработчики=CompletedAllSequentialHandlers
ЗавершитьВывод=FinishOutput
ЗавершитьВыгрузку=CompleteUpload
ЗавершитьВыгрузкуВТранзакции=CompleteUnloadingInTransaction
ЗавершитьДосрочно=FinishEarly
ЗавершитьДосрочноЕслиОшибка=EndEarlyIfError
ЗавершитьКонвертациюВариантовОтчетов=CompleteConversionOfReportVariants
ЗавершитьСоставнуюЗагрузку=CompleteMultipartUpload
ЗаголовкиПрав=TitlesRight
ЗаголовокHTTP=HTTPHeader
ЗаголовокВход=EntryHeader
ЗаголовокВыгрузкаДанных=HeaderUploadingData
ЗаголовокДанныхВыбора=SelectionDataHeader
ЗаголовокЗаказа=OrderHeader
ЗаголовокОбласти=AreaHeader
ЗаголовокПрава=TitlePermissions
ЗаголовокРезультата=ResultHeader
ЗаголовокСопоставлениеПользователей=HeaderMatchingUsers
ЗагружаемыйОбъектМетаданных=MetadataObjectToLoad
Загружать=ToImport
ЗагружатьДанные=UploadData_
ЗагружатьИУстанавливатьИсправленияАвтоматическиПриИзменении=DownloadAndInstallFixesAutomaticallyWhenChangesAreMade
ЗагружатьСписанияКакКорректировки=UploadWriteOffsAsAdjustments
ЗагрузитьВариант=LoadVariant
ЗагрузитьВерсииПодсистем=DownloadSubsystemVersions
ЗагрузитьДанныеАккредитованныхУЦ=UploadDataAccreditedCA
ЗагрузитьДанныеСериализуемогоЗначения=LoadSerializableValueData
ЗагрузитьДанныеТекущейОбластиИзАрхива=DownloadCurAreaDataFromArchive
ЗагрузитьДанныеТекущейОбластиИзАрхиваВФоне=LoadCurAreaDataFromArchiveInBackground
ЗагрузитьДифференциальнуюКопию=DownloadDifferentialCopy
ЗагрузитьКартинкуВыборФайла=UploadImageFileSelection
ЗагрузитьМенеджерРегистрацииОбменаДанными=DownloadDataExchangeRegistrationManager
ЗагрузитьРасширениеПослеВопросаЗаменыИмени=LoadExtensionAfterQuestionNameReplacement
ЗагрузитьТекущуюОбласть=LoadCurArea
ЗагрузитьТекущуюОбластьИзАрхива=LoadCurAreaFromArchive
ЗагрузитьТекущуюОбластьИзТома=LoadCurAreaFromVolume
ЗагрузкаНаКлиентеИлиНаСервереПриИзменении=LoadingOnClientOrOnServerWhenChange
ЗагрузкаПрервана=DownloadAborted
ЗаданиеВыполняется=TaskIsRunning
ЗаданиеЗаполненияПараметровРаботыРасширений=SettingFillingWorkParametersExtensions
ЗадачаПользователя=UserTask
ЗаказНаВозврат=RefundOrder
ЗаказНаОплату=OrderForPayment
Заказчик=Customer_
ЗаключениеУЦ=Conclusion
ЗакрывающихСкобок=ClosingParentheses
ЗакрытьЗапись=CloseRecord
ЗакрытьЗаписьДанныхНачальногоОбраза=CloseInitialImageDataWrite
ЗакрытьФормуОтветПолучен=CloseFormResponseReceived
ЗаменаИмениПодтверждена=NameReplacementConfirmed
ЗаменаСсылокВыполнена=ReplacingLinksIsDone
ЗаменитьВСтроке=ReplaceInline
ЗаменитьВФорматированнойСтроке=ReplaceInFormattedString
ЗаменитьПараметрыЗначениями=ReplaceParametersWithValues
ЗаменитьПараметрыПредставлениями=ReplaceParametersWithViews
ЗаменитьПредставленияПараметров=ReplaceViewParameters
ЗаменитьРольДобавлениеИзменениеЭлектронныхПодписейИШифрование=ReplaceRoleAddingChangeElectronicSignaturesAndEncryption
ЗаменитьЭлементыФормулы=ReplaceFormulaElements
ЗанятьФайлДляРедактирования=BorrowFileToEdit
ЗаписанныйРазмер=RecordedSize
ЗаписаноЭлементов=WrittenItems
ЗаписаноЭлементовПослеПроверкиРазмераФайла=WrittenItemsAfterCheckFileSize
ЗаписатьАдресАнонимногоСервисаИнтеграцииСИнформационнымЦентромУСП=WriteDownAddressOfAnonymousIntegrationServiceWithUSPInformationCenter
ЗаписатьАдресВнешнегоАнонимногоИнтерфейсаУСП=WriteAddressOfExternalAnonymousInterface
ЗаписатьАдресПочтыАбонентаДляИнтеграцииСУСП=RecordSubscriberSEmailAddressForSuspIntegration
ЗаписатьВЖурналСобытийОчисткиФайлов=WriteToEventLogCleanupFiles
ЗаписатьВРезультатыОбменаДанными=WriteToDataExchangeResults
ЗаписатьДанныеВосстанавливаемыхРасширенийОбласти=RecordDataOfRecoverableAreaExtensions
ЗаписатьДанныеДляИзмененияМультиязычныхРеквизитов=WriteDataToChangeMultilingualAttributes
ЗаписатьДанныеНастроекИнтеграцииСУСП=RecordDataForSuspIntegrationSettings
ЗаписатьИнформациюОПроцедуреЗагрузки=RecordInformationAboutBootProcedure
ЗаписатьКодРегистрацииВУСП=WriteVUSPRegistrationCode
ЗаписатьНастройкиАвторизации=WriteAuthorizationSettings
ЗаписатьНачальныйОбразАвтономногоРабочегоМеста=WriteInitialImageofAutonomousWorkplace
ЗаписатьПризнакПодтвержденияКодаДляИнтеграцииСУСП=RecordCodeConfirmationFlagForIntegrationOfSuspension
ЗаписатьПрогрессВыполненияОбработчика=WriteProgressProgressHandler
ЗаписатьРазмерМетаданныхПриложения=RecordApplicationMetadataSize
ЗаписатьРазмерПриложения=RecordApplicationSize
ЗаписатьСобытиеВЖурналРегистрации=WriteEventToRegistrationLog
ЗаписатьСписокФайловДляЗагрузки=WriteListOfFilesToDownload
ЗаписатьЭлементДанныхНачальногоОбраза=WriteInitialImageDataElement
ЗаписьНабораОповещений=WriteAlertSet
ЗаписьНовая=NewEntry
ЗаписьПолногоАрхива=RecordingFullArchive
ЗаписьПользовательскихРасширений=WritingCustomExtensions
ЗаписьПоставляемогоРасширения=RecordingSuppliedExtension
ЗаписьПоставляемыхРасширений=RecordingSuppliedExtensions
ЗаписьСтекаНастроек=WriteStackSettings
ЗапланироватьРаспространениеКлассификатораПоОД=PlanTheDistributionOfTheClassifierByOD
ЗапланироватьРасчетРазмераПриложения=ScheduleApplicationSizeCalculation
ЗапланироватьРегламентноеЗаданиеСервер=ScheduleRegulatoryJobServer
ЗапланироватьУдалениеФайла=ScheduleFileDeletion
ЗаполнениеДанныхАктивации=FillingInActivationData
ЗаполнениеНастроекОблачногоСервиса=FillingInCloudServiceSettings
ЗаполненныеВидыДоступаСеанса=FilledSessionAccessTypes
ЗаполненныеВозможныеПраваСеанса=PopulatedPossibleSessionPermissions
ЗаполнитьАдресаСерверовМетокВремени=FillinServerAddressesTimestamps
ЗаполнитьАдресПочты=FillinMailAddress
ЗаполнитьАктивноеФоновоеЗадание=FillActiveBackgroundQuest
ЗаполнитьВерсииПодсистем=FillinSubsystemVersions
ЗаполнитьВзаимодействие=FillInInteraction
ЗаполнитьВсеПараметрыРаботыПоследнейВерсииРасширений=FillinAllJobParametersLatestVersionExtensions
ЗаполнитьДанныеАвторизации=FillInAuthorizationData
ЗаполнитьДанныеВыбораЭлементаОтбора=FillSelectionItemSelectionData
ЗаполнитьДанныеПечати=FillDataPrint
ЗаполнитьДеревоОбъектовНаСервере=PopulateObjectTreeOnServer
ЗаполнитьДополнительноеСвойство=FillAdditionProperty
ЗаполнитьДополнительныеСвойства=FillinAdditionalProperties
ЗаполнитьИПеренестиСтрокиИзТЧПредставленияВРеквизиты=FillAndMoveLinesFromPchViewToRequisites
ЗаполнитьКраткийСоставДокумента=FillInShortCompositionOfDocument
ЗаполнитьМассивЗависимыхПодсистемРекурсивно=FillArrayOfDependentSubsystemsRecursively
ЗаполнитьМассивЗависитОтПодсистемРекурсивно=FillArrayDependsOnSubsystemsRecursively
ЗаполнитьМультиязычныеРеквизиты=FillMultilingualRequisites
ЗаполнитьНастройкиДляУсовершенствованияПодписей=FillinSettingsToImproveSignatures
ЗаполнитьНепросмотренныеВзаимодействия=FillInUnseenInteractions
ЗаполнитьОбращения=FillOutRequests
ЗаполнитьОбъектНачальнымиДанными=FillObjectInitialData
ЗаполнитьПереписку=FillInCorrespondence
ЗаполнитьПерепискуПоОбращению=FillInCorrespondenceOnRequest
ЗаполнитьПерепискуПоОбращениюКлиент=FillInCorrespondenceOnRequestClient
ЗаполнитьПодвал=FillBasement
ЗаполнитьПодпись=FillSignature
ЗаполнитьПояснения=FillinExplanations
ЗаполнитьПриоритетыТиповМетаданных=FillInMetaDataTypePriorities
ЗаполнитьРегистрационныеДанныеОрганизации=FillInTheRegistrationDataOfTheCompany
ЗаполнитьРеквизитИТЧПредставления=FillPropsITCHSubmissions
ЗаполнитьРеквизитыНачальнымиДанными=FillRequisitesInitialData
ЗаполнитьСвойстваМакетовЗаголовковОтчета=FillReportHeaderLayoutProperties
ЗаполнитьСлужебныеСвойстваРазделов=FillinServicePropertiesSections
ЗаполнитьСодержание=FillInContent
ЗаполнитьСодержаниеОбращения=FillInRequestContent
ЗаполнитьСоответствиеОбъектовПодсистемамПоВыгрузке=FillInCorrespondenceOfObjectsToSubsystemsForUnloading
ЗаполнитьСоответствиеОбъектовПодсистемамПоСписку=FillInCorrespondenceOfObjectsToSubsystemsInList
ЗаполнитьСписокВыбораПоля=FillFieldSelectionList
ЗаполнитьСписокВыбораТиповЗначенийДополнительныхСвойств=FillInListForSelectingValueTypesForAdditionalProperties
ЗаполнитьСписокОбластей=FillListAreas
ЗаполнитьСписокОбработчиков=FillHandlerList
ЗаполнитьСписокОбращений=FillInListOfRequests
ЗаполнитьСписокОбращенийКлиент=FillInListOfRequestsClient
ЗаполнитьСписокОтображаемыхПолей=FillListDisplayedFields
ЗаполнитьСписокТиповПодписейКриптографии=FillListSignatureTypesCryptography
ЗаполнитьСтандартныеРолиРасширений=FillStandardExtensionRoles
ЗаполнитьТолькоОписаниеПрав=FillOnlyDescriptionPermissions
ЗаполнитьУровниДоступа=FillAccessLevels
ЗаполнитьШаблономСодержание=FillContentWithTemplate
ЗаполнитьЭлементыФормы=FillInFormElements
ЗаполняемыйОбъект=ObjectToFillIn
Заполнять=FillIn
ЗаполнятьДанныеНовыхПодсистемПриПереходеСДругойПрограммы=FillDataNewSubsystemsWhenSwitchingFromAnotherProgram
ЗапросВременных=RequestTemporary
ЗапросДляПродленияДостоверностиПодписей=RequestForExtensionSignatureCredibility
ЗапросОтвет=RequestResponse
ЗапросыВыбор=SelectionRequests
ЗапросыИмяПриИзменении=NameQueriesWhenChanging
ЗапросыКоманднаяПанель=RequestsCommandPanel
ЗапросыКонтекстноеМенюСравнитьРезультатыЗапросов=QueriesContextMenuCompareQueryResults
ЗапросыНаПредоставлениеДоступаНажатие=RequestsToGrantAccessClick
ЗапросыПередНачаломДобавления=RequestsBeforeAdding
ЗапросыПередУдалением=RequestsBeforeDeletion
ЗапросыСостояниеПросмотра=RequestsStatusView
ЗапросыСтрокаПоиска=QueriesSearchBar
ЗапросыУправлениеПоиском=QueriesSearchManagement
ЗапуститьЗавершениеСеансовНаСервере=RunSessionTerminationOnServer
ЗапуститьЗаполнениеПараметровРаботыРасширений=StartFillingWorkParametersExtensions
ЗапуститьОбновлениеПараметровРаботыРасширенийВФонеНаСервере=RunUpdateSettingsExtensionsWorkInBackgroundOnServer
ЗапуститьФоновыйРасчетРазмераПриложения=StartBackgroundCalculationOfAppSize
ЗарегистрироватьАдминистративнуюОшибку=LogAdministratorError
ЗарегистрироватьОшибкуУсовершенствованияПодписиВЖурнале=LogErrorImprovementsSignaturesInLog
ЗарегистрироватьПроблемуСДанными=FileIssueWithData
ЗарегистрироватьУсовершенствованиеПодписиВЖурнале=RegisterImprovementSignaturesInJournal
ЗарплатаSearchControl=SalarySearchControl
ЗарплатаSearchControlContextMenu=SalarySearchControlContextMenu
ЗарплатаSearchString=SalarySearchString
ЗарплатаSearchStringContextMenu=SalarySearchStringContextMenu
ЗарплатаViewStatus=SalaryViewStatus
ЗарплатаViewStatusContextMenu=SalaryViewStatusContextMenu
ЗарплатаКоманднаяПанель=SalaryCommandPanel
ЗафиксироватьЗавершениеЗагрузкиОбъектовМетаданных=CaptureCompletionOfLoadingMetadataObjects
ЗафиксироватьЗавершениеПроцедурыЗагрузки=FixCompletionOfBootProcedure
ЗафиксироватьНачалоЗагрузкиОбъектаМетаданных=FixStartOfLoadingMetadataObject
ЗафиксироватьНачалоПроцедурыЗагрузки=FixStartOfBootProcedure
ЗащитаОтОпасныхДействийНеПредупреждать=ProtectionAgainstDangerousActionsDoNotWarn
ЗаявлениеНаСертификатПослеДобавления=CertificateApplicationAfterAdding
ЗаявленияНаВыпускСертификата=CertificateIssuanceApplications
ЗаявленияНаВыпускСертификатаВРаботе=CertificateIssuanceApplicationsInProgress
Здание=BuildingUnit
Здравствуйте=Hello
ЗначениеАртефакта=ArtifactValue
ЗначениеВФормеНачалоВыбора=ValueInFormStartOfSelection
ЗначениеВФормеПриИзменении=ValueInFormWhenChanging
ЗначениеДата=DateValue
ЗначениеДоступаРасшифровка=AccessValueDecryption
ЗначениеКлючаОбъекта=ObjectKeyValue
ЗначениеКлючевогоРеквизита=ValueOfKeyProps
ЗначениеНаОсновномЯзыке=ValueInMainLanguage
ЗначениеНастройкиРасчета=CalculationSettingValue
ЗначениеНачальногоОтбора=InitialFilterValue
ЗначениеОсновнойЯзык=ValueMainLanguage
ЗначениеПереименования=RenamingValue
ЗначениеПоТипу=ValueByType
ЗначениеСеанса=SessionValue
ЗначениеСписок=ListValue_1
ЗначениеУзловКонфигурации=MeaningOfConfigurationNodes
ЗначениеЭлементаОтбора=ValueOfSelectionElement
ЗначениеЯзык1=ValueLanguage1
ЗначениеЯзык2=ValueLanguage2
ЗначенияВыбранногоПараметра=ValuesofSelectedParameter
ЗначенияДополнительногоСведения=AdditionalInformationValues
ЗначенияПоиска=SearchValues
ЗначенияПустойСсылки=ValuesEmptyReferences
ЗначенияЯзыковыхКонстант=ValuesLanguageConstants
ЗначТипШтрихкода=BarcodeType
ЗначШтрихкод=EnterBarcode
ИдентитификаторФайла=FileIdentifier
ИдентификаторАбонента=SubscriberID
ИдентификаторГиперссылки=IdentifierHyperlinks
ИдентификаторЗаполнения=FillId
ИдентификаторЗаполненияПараметровРаботыРасширений=IdFillingExtensionsJobParameters
ИдентификаторКопии=CopyID
ИдентификаторКорня=RootId
ИдентификаторНапоминания=ReminderID
ИдентификаторОбновления=UpdateID
ИдентификаторОбъект=ObjectID
ИдентификаторОригинальногоПисьмаMicrosoft=MicrosoftOriginalLetterId
ИдентификаторРК=RCID
ИдентификаторСтрокиПравилаВыгрузки=IDOfUploadRuleLine
ИдентификаторСхемыКомпоновкиДанных=DataCompositionSchemaId
ИдентификаторСчета=AccountID_
ИдентификаторТекущегоЗадания=CurrentJobID
ИдентификаторФайлаS3=S3FileId
ИдентификаторФайлаДифференциальнойКопии=IDOfDifferentialCopyFile
ИдентификаторФайлаИсточника=IDOfSourceFile
ИдентификаторФайлаПолнойКопии=IDOfFullCopyFile
ИдентификаторыВидовСравнения=ComparisonViewIDs
ИдентификаторыДляФормул=IdentifiersForFormulas
ИдентификаторыИмен=NameIdentifiers
ИдентификаторыКлючейРасширений=ExtensionKeyIds
ИдентификаторыПоставляемыхПрофилей=SuppliedProfileIDs
ИдентификаторыРазворачиваемыхСтрок=ExpandableRowIds
ИдентификаторыРолейСеанса=SessionRoleIds
ИдентификаторыСеанса=SessionIds
ИдентификаторыСертификатов=CertificateIDs
ИдентификаторыУдаленныхИОтключенныхРолей=IDsofRemovedAndDisabledRoles
ИДПользователя=UserID_1
ИерархияПодсистемКоманднаяПанель=HierarchyOfSubsystemsCommandPanel
ИерархияПодсистемПометкаПриИзменении=HierarchyOfSubsystemsMarkingWhenChanges
ИерархияПодсистемПриАктивизацииСтроки=HierarchyOfSubsystemsWhenActivatingLine
ИерархияПодсистемСостояниеПросмотра=HierarchyOfSubsystemsViewState
ИерархияПодсистемСтрокаПоиска=HierarchyOfSubsystemsSearchString
ИерархияПодсистемУправлениеПоиском=HierarchyOfSearchManagementSubsystems
ИерархияПолей=FieldHierarchy
ИзбыточнаяУстановкаРазделителя=RedundantSeparatorSetting
ИзвлечьФайл=ExtractFile
ИзменениеИсторииДанных=ChangeDataHistory
ИзменениеИсторииДанныхОтсутствующихДанных=ChangingDataHistoryMissingData
ИзменениеКомментарияВерсииИсторииДанных=ChangeCommentVersionDataHistory
ИзменениеНастроекИсторииДанных=ChangeDataHistorySettings
ИзменениеЯзыка=ChangeLanguage
ИзмененныеПараметрыОбновления=ChangedUpdateParameters
ИзмениласьПометкаУдаления=DeletionTagHasChanged
ИзменитьОтметкуОНапоминании=EditMarkONReminder
ИзменитьПолеЗапросаПодТекущийЯзык=ChangeRequestFieldUnderCurrentLanguage
ИзменитьПометкиКандидатов=EditCandidatesNotes
ИзменитьРегламентноеЗаданиеПродлениеДостоверностиПодписей=ChangeRegulatoryTaskExtensionCredibilitySignatures
ИзменитьСчетНаОплату=ChangeInvoiceForPayment
ИзменитьТекстНапоминанийПоПредмету=EditReminderTextOnSubject
ИзменитьФлажки=EditCheckboxes
ИзменитьЯзыкВМультиязычныхРеквизитахКонфигурации=ChangeLanguageinMultilingualDetailsConfig
ИзменитьЯзыкВНезависимыхРегистрахСведений=ChangeLanguageIncaseIndependentDetails
ИзменитьЯзыкВПодчиненныхРегистрахСведений=ChangeLanguageInSubRegistersDetails
ИзменяемаяЗапись=ModifiableRecord
ИменаГруппировок=GroupingNames
ИменаДат=DateNames
ИменаИнтерактивныхПриложений=InteractiveApplicationNames
ИменаКоллекцийПоИменамБазовыхТипов=CollectionNamesByBaseTypeNames
ИменаОбъектовСМультиязычнымиРеквизитами=ObjectNamesWithMultilingualAttributes
ИменаПредопределенныхБезЗаполнения=NamesPredefinedWithoutFilling
ИменаСвойствСозданияПодписки=SubscriptionCreationPropertyNames
ИменаТабличныхЧастейОбъекта=ObjectTablePartNames
ИменаУстановленныхИсправлений=NamesOfInstalledFixes
Именительный=Nominative
ИмитироватьПроблемыСДаннымиИОбработчиком=SimulateProblemsWithDataAndHandler
ИмяБазыИзменениеТекстаРедактирования=BaseNameEditTextChange
ИмяБазыПриИзменении=BaseNameOnChange
ИмяВедущегоПрава=HostRightName
ИмяВложений=AttachmentName
ИмяГруппыОператоров=OperatorGroupName
ИмяДляПодпапок=SubfolderName
ИмяИзСинонима=NameFromSynonym
ИмяИОтчествоСертификата=NameAndPatronymicOfCertificate
ИмяИОтчествоСубъекта=NameAndPatronymicOfSubject
ИмяИРасширениеФайла=FileNameAndExtension
ИмяИсточникаПолей=FieldSourceName
ИмяКолонкиПредставление=ColumnNameView
ИмяКомандыПереходаМеждуИзменениямиНастроек=CommandNameTransitionBetweenSettingChanges
ИмяКонстантыАРМБазовойФункциональности=ConstantNameArmBasicFunctionality
ИмяМететода=MetetodeName
ИмяМетодаВыгрузкиДанных=NameOfDataUploadMethod
ИмяМодуляИнтеграцииБИП=NameOfBIPIntegrationModule
ИмяМодуляУправлениеПечатьюКлиент=ModuleNamePrintManagementClient
ИмяНадписиРешение=LabelNameSolution
ИмяОбработкиТранспортаСообщений=NameOfMessageTransportProcessing
ИмяОбъектСТЧПредставления=NameObjectSTCHView
ИмяОсновногоИсточника=PrimarySourceName
ИмяОсновногоИсточникаДанных=MainDataSourceName
ИмяПараметраЗавершитьРаботуПользователей=ParameterNameShutdownUsers
ИмяПараметраРазрешитьРаботуПользователей=ParameterNameAllowUsers
ИмяПараметраУсловия=ParameterNameConditions
ИмяПараметраХраненияОтказаОтПредупреждения=StorageParameterNameWarningDisclaimer
ИмяПланаОбменаСиноним=ExchangePlanNameSynonym
ИмяПланаОбменаСтаройНастройки=NameOfOldConfigurationExchangePlan
ИмяПоЗначению=NameByValue
ИмяПоляИсточникаДанных=DataSourceFieldName
ИмяПочтовогоСервера=MailServerName
ИмяРеквизитаНаДругомЯзыке=PropsNameInAnotherLanguage
ИмяСведения=NameOfInformation
ИмяСобытияАвторизацияПоПротоколуOAuth=EventNameAuthorizationByProtocolOAuth
ИмяСобытияЖурналРегистрации=EventNameLog
ИмяСобытияЗаполненияПараметров=ParameterFillingEventName
ИмяСобытияИзмененияСоставаБыстрыхНастроек=EventNameQuickSettingsChangesContent
ИмяСобытияФормыНастроек=NameEventFormSettings
ИмяТаблицыВОбластиМакета=TableNameINLayoutArea
ИмяТаблицыИзменений=NameOfChangeTable
ИмяТаблицыМетаданныхСрезПоследних=NameOfSliceMetadataTable
ИмяТаблицыПоля=FieldTableName
ИмяТипаПлатформы=NameOfThePlatformType
ИмяФайлаВАрхиве=FileNameInArchive
ИмяФайлаВыгрузкиДанных=NameOfDataUploadFile
ИмяФайлаВыгрузкиНачалоВыбора=UploadFileNameStartOfSelection
ИмяФайлаВыгрузкиОткрытие=UploadFileNameOpening
ИмяФайлаВыгрузкиПриИзменении=NameOfUploadFileWhenChanged
ИмяФайлаДанныхПользовательскогоРасширения=NameOfUserExtensionDataFile
ИмяФайлаЗагрузкиНачалоВыбора=DownloadFileNameStartOfSelection
ИмяФайлаЗагрузкиОткрытие=DownloadFileNameOpening
ИмяФайлаПолногоАрихва=FileNameOfFullArihva
ИмяФайлаПолногоАрхива=FullArchiveFileName_
ИмяФайлаПользовательскихРасширений=FileNameOfCustomExtensions
ИмяФайлаПользовательскогоРасширения=NameOfCustomExtensionFile
ИмяФайлаПоставляемыхРасширений=FileNameOfSuppliedExtensions
ИмяФормыАктивныеПользователи=FormNameActiveUsers
ИмяФормыВопроса=QuestionFormName
ИмяФормыИсточника=FormSourceName
ИмяФормыМиграции=NameOfMigrationForm
ИмяЭлементаВводитьПарольВПрограммеЭлектроннойПодписи=ItemNameEnterPasswordInElectronicSignatureProgram
ИмяЭлементаПризнака=NameOfAttributeElement
ИмяЭлементаСостояния=NameOfStateElement
Инверсия=Inversion
ИндексЗагружаемого=UploadIndex
ИндексИмени=NameIndex
ИндексПервогоЗагружаемого=IndexOfFirstUpload
ИндексПоискаОтчетовКонфигурации=IndexSearchReportsConfiguration
ИндексПоискаОтчетовРасширений=IndexSearchReportsExtensions
ИндексПоследнейМетки=IndexLastLabels
ИндексПотока=StreamIndex
ИндексТекущихНастроек=IndexCurrentSettings
ИнициализацияПравилРегистрации=InitializingRegistrationRules
ИнициализироватьТаблицуИсключений=InitializeExceptionTable
ИнструкцияЕдиницыИзмерения=InstructionUnitsOfMeasurement
ИнструкцияТНВЭД=HSInstruction
ИнструментРазработчикаОбновлениеВспомогательныхДанных=DeveloperToolUpdateAuxiliaryData
ИнтеграцияСПлатежнымиСистемами=IntegrationWithPaymentSystems
ИнтерактивноеИспользованиеЭлектронныхПодписейИШифрования=InteractiveUseofElectronicSignaturesandEncryption
ИнтерактивныйЗапуск=InteractiveLaunch
ИнтерактивныйЗапускВыгрузкиВСводноеПриложение=InteractiveLaunchOfUploadingToSummaryApplication
ИнтерактивныйЗапускЗагрузкиВСводноеПриложение=InteractiveLaunchOfDownloadToSummaryApplication
ИнтервалПроверки=CheckInterval
ИнтернетПоддержкаИСервисы_БИПОнлайнОплатыПриИзменении=OnlineSupportAndServices_BIPOnlinePaymentWhenChanging
ИнтернетПоддержкаИСервисы_ДекорацияРасписаниеПолученияУведомленийОтОнлайнОплатНажатие=InternetSupportServices_DecorationScheduleReceivingNotificationsFromOnlinePaymentsClick
ИнтернетПоддержкаИСервисы_ПолучениеУведомленияОтОнлайнОплатПриИзменении=InternetSupportAndServices_ReceivingNotificationsFromOnlinePaymentsWhenChangesAreMade
ИнформационнаяНадписьОтборОбработкаНавигационнойСсылки=HelpTextFilterURLProcessing
информационной=Information
ИнформацияОО=PublicOrganizationInformation
ИнформацияОПользовательскихРасширениях=InformationAboutCustomExtensions
ИнформацияОПользовательскомРасширении=UserExtensionInformation
исключений=Exceptions
ИсключитьОбъект=ExcludeObject
ИсключитьОбъектИзОчистки=ExcludeObjectFromCleanup
ИспользованиеВариантовОтчетов=UsingReportOptions
ИспользованиеЗаметок=UsingNotes
ИспользованиеНапоминаний=UsingReminders
ИспользованиеРазрешено=UsageIsAllowed
ИспользованиеСтруктурыПодчиненности=UsingSubordinationStructure
ИспользованиеТекущихДел=UsingCurCases
ИспользованиеУчетныхЗаписейЭлектроннойПочты=UsingEmailAccounts
ИспользованиеЭлектроннойПодписиИШифрования=UseOfElectronicSignatureAndEncryption
ИспользованиеЭП=UsingItemInstance
ИспользованиеЭЦП=UsingEDS
ИспользоватьSTARTTLSДляВходящейПочты=UseSTARTTLSForIncomingMail
ИспользоватьНесколькоОрганизацийПриИзменении=UseMultipleOrganizationsWhenChanging
ИспользоватьОбщиеНастройкиВходаПользователейСервиса=UseCommonSettingsOfServiceUserAuthorization
ИспользоватьОптимизированнуюЗапись=UseOptimizedRecord
ИспользоватьОтборПоОрганизациямПриИзменении=UseOrganizationSelectionWhenChanging
ИспользоватьОтборПоПодразделениямПриИзменении=UseSelectionByDivisionWhenChanging
ИспользоватьОтборПоСкладамПриИзменении=UseWarehouseSelectionWhenChanging
ИспользоватьПромокодСМеткой=UsePromoCodeWithTag
ИспользоватьСервис1СТакском=UseService1WithATax
ИспользоватьСервисDSS=UseDSSService
ИспользоватьТекущуюДатуКомпьютераПриИзменении=UseCurDateOfComputerWhenChanging
ИспользоватьФорматFastInfoSetПриИзменении=UseFastInfoSetFormatWhenChanging
ИспользуемыеЯзыки=LanguagesUsed
ИспользуетсяБанкДляРасчетовПриИзменении=SettlementBankUsedOnChange
ИспользуетсяВсегда=UsedAlways
ИспользуютсяНапоминанияПользователя=UsedUserReminders
ИсправитьПризнакПроверкаПроведенияПередПечатью=FixTagCheckingHandlingBeforePrinting
ИсправленияЗаголовокСсылкиДействия=PatchesTitleReferencesActions
ИсправленияКоманднаяПанель=CorrectionsCommandBar
ИсправленияСнятьОтметкуСоВсех=CorrectionsUncheckAll
Истекает=Expires
ИсточникиДанныхПечати=PrintDataSources
ИсточникиПолей=FieldSources
ИсточникиПоТипам=SourcesByTypes
ИсточникиПравилМенеджеры=RuleSourcesManagers
ИсточникОграниченийПриИзменении=SourceOfRestrictionsOnChanges
ИсточникПараметровДоступа=SourceOfAccessParameters
ИсточникСравненияПриИзменении=SourceOfComparisonWhenChanging
ИсходноеВыражение=OriginalExpression
ИсходныйЯзыкПриИзменении=SourceLanguageWhenChanged
ИтоговыйМассивЗапросов=FinalArrayOfRequests
ИтогоНДСВСумме=TotalNDSVAmount
ИтогоНДССверху=TotalVATOnTop
КаналСообщения=MessageChannel
КанонизацияСМЭВ=CanonizationSMEV
Карт=Maps
КартинкаГеографическаяСхема=PictureGeographicalDiagram
КартинкаПоСостояниюОбращения=ImageByStateOfRequest
КартинкаПроблемСДанными=ImageProblemsWithData
КартинкаПроблемСОбработчиками=ImageProblemsWithHandlers
КартинкаСправочник=ImageCatalog
КаталогВыгрузкиНачалоВыбора=DumpDirectoryStartChoice
КаталогОбщегоВременногоХранилищаФайлов=DirectoryofSharedTemporaryFileStorage
КаталогРасширенийНажатие=ExtensionsDirectoryClick
КаталогСП=SPCatalog
КаталогФайловойБазыНачалоВыбора=FileDatabaseDirectoryStartOfSelection
КешироватьРезультат=Cache_Result
КешПользователей=UserCache
КИ=KI
КиЗ=KiZ
Классификатор=Classifier
КлиентПриИзменении=ClientOnChange
КлючБезопасногоХранилища=SecureStorageKey
КлючВариантаБезУсловий=OptionKeyWithoutConditions
КлючВсеПодсистемы=KeyAllSubsystems
КлючЗаписиПрогрессаОбновления=KeyRecordProgressUpdates
КлючПоискаАнглийский=SearchKeyEnglish
КлючПоискаРусский=KeySearchRussian
КлючРоли=KeyRole
КлючУпорядочения=OrderingKey
КнопкаНастройкиФормата=ButtonSettingsFormat
КнопкаУдаленияФайла=DeleteFileButton
КнопкаУстановкиСтандартныхНастроек=ButtonSetStandardSettings
КодАвторизации=AuthorizationCode
КодВалюты=CurrencyCode_
КодВедущегоАбонента=MasterSubscriberCode
КодВерный=CodeIsCorrect
КодВладельца=OwnerCode
КодДополнительногоУзла=AdditionalNodeCode
КодироватьСтрокуМетодомS256=EncodeStringMethodS256
КодНаКомпьютере=ComputerCode
КодНастройки=SetupCode
КодОбслуживаемогоАбонента=CodeOfServedSubscriber
КодОбъекта=ObjectCode
КодОсновногоУзла=MainNodeCode
КодОтправлен=CodeSent
КодОшибкиНеизвестнаяОшибка=ErrorCodeUnknownError
КодПериодаДействия=ValidityPeriodCode
КодПодтвержден=CodeConfirmed
КодПодтвержденияТелефонИзменениеТекстаРедактирования=ConfirmationCodePhoneNumberEditTextChange
КодПодтвержденияТелефонПриИзменении=ConfirmationCodePhoneNumberOnChange
КодПодтвержденияТелефонСтарыйИзменениеТекстаРедактирования=ConfirmationCodeOldPhoneNumberEditTextChange
КодПодтвержденияТелефонСтарыйПриИзменении=ConfirmationCodeOldPhoneNumberOnChange
КодПодтвержденияЭлектроннаяПочтаИзменениеТекстаРедактирования=ConfirmationCodeEmailEditTextChange
КодПодтвержденияЭлектроннаяПочтаПриИзменении=ConfirmationCodeEmailOnChange
КодПокупателя=BuyerSCode
КодПользователяДляДоступа=UserCodeForAccess
КодПородавца=PeddlerCode
КодПравила=RuleCode
КодПродавца=SellerCode
КодРодителя=ParentCode
КодРоли=RoleCode
КодСостоянияОжидание=StateCodePending
КодСтраныТолькоЦифры=CountryCodeNumbersOnly
КодСтроки=RowCode
КодТекущегоЯзыка=CodeCurrentLanguage
КодТелефонаИзменениеТекстаРедактирования=PhoneCodeEditTextChange
КодТелефонаПриИзменении=PhoneCodeOnChange
КодУчетнойСистемы=AccountingSystemCode
КодыНаКомпьютерах=CodesOnComputers
КодыОтветов=ResponseCodes
КодЭлемента=ElementCode
КодЭлементаКонфигурация=ItemCodeConfig
КодЯзыкаБезРегиона=LanguageCodeWithoutRegion
КоличествоДнейВДекаде=NumberOfDaysPerDecade
КоличествоДнейВНеделе=NumberOfDaysInWeek
КоличествоДнейДляОповещенияОбОкончанииСрокаДействия=NumberofDaysforEndofTermAlert
КоличествоДо=NumberUpTo
КоличествоДт=CountDr
КоличествоЗаявленийВРаботе=NumberofApplicationsInProgress
КоличествоИмен=NumberofNames
КоличествоКонечныйОстатокДт=CountClosingBalanceDr
КоличествоКонечныйОстатокКт=CountClosingBalanceCr
КоличествоКт=CountCr
КоличествоМесяцев=NumberOfMonths
КоличествоМесяцевВГоду=NumberOfMonthsInYear
КоличествоМесяцевВКвартале=NumberOfMonthsInQuarter
КоличествоМесяцевВПолугодии=NumberOfMonthsInHalfYear
КоличествоМиллиметровВПикселеВысота=NumberOfMillimetersPerPixelHeight
КоличествоМиллиметровВПикселеШирина=NumberOfMillimetersPerPixelWidth
КоличествоНастроекСтека=NumberofStackSettings
КоличествоНачальныйОстатокДт=CountOpeningBalanceDr
КоличествоНачальныйОстатокКт=CountOpeningBalanceCr
КоличествоНеобработанныхПодписей=NumberofRawSignatures
КоличествоОборотДт=CountTurnoverDr
КоличествоОбработанныхПорций=NumberofPortionsProcessed
КоличествоОшибокПриАвтоматическомПродлении=NumberofErrorsonAutomaticRenewal
КоличествоПовторений=NumberofReps
КоличествоПодключенныхРасширений=NumberofConnectedExtensions
КоличествоПодписейДляДобавленияАрхивныхМеток=Numberofsignaturestoaddarchivaltags
КоличествоПодписейДляУсовершенствования=Numberofsignaturesforimprovements
КоличествоПотоковСУчетомУправляющегоПотока=NumberofThreadsincludingtheControlThread
КоличествоПроблемВОбработчиках=NumberofProblemsInHandlers
КоличествоПроблемСДанными=NumberofProblemswithData
КоличествоПроверок=NumberOfChecks
КоличествоРаботающихПотоков=NumberofRunningThreads
КоличествоРасширений=Numberofextensions
КоличествоСекундВСутках=NumberOfSecondsInDay
КоличествоСертификатовСИстекающимСрокомДействия=NumberofCertificatesWithexpiringValidity
КоличествоСутокВСекундах=NumberOfDaysInSeconds
КоличествоЭлементовПроверкиРазмераФайла=NumberofItemsFileSizeCheck
КоличествоЯчеек=NumberOfBins
КоллекцииРеквизитов=CollectionsProps
КоллекцияДанных=DataCollection
КоллекцияДокументов=DocumentCollection
КоллекцияПараметровПолученияДанныхИсточников=CollectionParametersGettingDataSources
КолонкаОбразец=ColumnPattern
КолонкаРеквизита=ColumnProps
КолонкиВXMLФайле=ColumnsInXMLFile
команд=Teams
КомандаОтправитьЗаявление=SendApplicationCommand
КомандаПрофили=CommandProfiles
КомандаРоли=CommandRoles
КомментарийАдресаДоставкиПриИзменении=CommentOnDeliveryAddressWhenChanging
Комп=Comp
КонецВторойСтроки=EndOfSecondLine
КонецЗапроса=EndRequest
КонецУсловия=EndOfCondition
КонечнаяТочкаМенеджераСервисаНастроена=ServiceManagerEndpointConfigured
КонкурентПриИзменении=CompetitorWhenChanging
КонПериода=NdPeriod
КонструкторКлюча=KeyConstructor
КонструкторПечатныхФорм=PrintableFormConstructor
КонтактПочта=ContactMail
КонтактТелефон=ContactPhone
КонтактыПровайдера=ProviderContacts
КонтейнерПодписи=ContainerSignatures
КонтекстОтчетаПоОбъекту=ReportContextByObject
КонтрагентПриИзменении=CounterpartyOnChange
КонтрагентыДляМониторинга=CounterpartiesForMonitoring
КонтролируемыеПараметрыЗагрузки=ControlledLoadingParameters
КонфигурацияНеПоддерживается=ConfigurationIsNotSupported
КонфликтыВторогоОбработчика=SecondHandlerConflicts
КонфликтыЗеркально=ConflictsMirrored
КоординатыОбласти=CoordinatesOfArea
КопируемаяОбласть=CopyArea
КопияОбработкиНаСервере=CopyOfProcessingOnServer
КПППриИзменении=CRTROnChange
КраткийСостав=ShortComposition
КраткийТекстОшибки=ShortErrorText
КраткоеОписание=BriefDescription
КраткоеПредупреждение=BriefWarning
КритерийПоискаВсе=SearchCriteriaAll
Куб=Cube
Куки=Cookies
ЛевоОбласти=LeftField
ЛегендаНастроекПрав=LegendSettingsRights
ЛишнийФайлВТоме=ExtraFileInTome
ЛогинПользовательДляЗагрузки=LoginUserToUpload
ЛогинПользователяДляВыгрузки=UserLoginForUploading
ЛогинПользователяДляЗагрузки=UserLoginForUploading_
ЛогинСодержитНеДопустимыеСимволы=LoginContainsInvalidCharacters
Логирование=Logging
ЛогироватьHTTPЗапрос=LogHTTPRequest
МакетПечатнойФормыПоИдентификатору=PrintableFormLayoutByID
МакетыВыбор=TemplatesSelection
МакетыИспользуется=TemplatesUsed
МакетыКоманднаяПанель=TemplatesCommandBar
МакетыПечатныхФормПредставления=LayoutsPrintedFormsPresentation
МакетыПоТипам=LayoutsByTypes
МакетыПоТипу=LayoutsByType
МакетыПредставление=TemplatesPresentation
МакетыПриАктивизацииСтроки=TemplatesOnActivateRow
МакетыСостояниеПросмотра=TemplatesViewStatus
МакетыСтрокаПоиска=TemplatesSearchString
МакетыУправлениеПоиском=TemplatesSearchControl
МаксимальноеКоличествоФизическихЛиц=MaximumNumberOfIndividuals
МаксимальноеКоличествоЭлементов=MaximumNumberOfElements
МаксимальныйНомерВерсии=MaxVersionNumber
МаксимальныйПериодРасчетаМетаданных=MaximumMetadataCalculationPeriod
МаксимальныйПериодРасчетаОбъектаМетаданных=MaximumCalculationPeriodForMetadataObject
МаксимальныйРазмерВложенийДляОтправкиСообщенияВПоддержкуСервиса=MaximumSizeOfAttachmentsForSendingMessagesToSupport
МаксимальныйРазмерСтекаНастроек=MaxStackSizeSettings
МаксимальныйРазмерФайлаВПамяти=MaximumFileSizeInMemory
МаркерОбновлен=MarkerUpdated
МассивВладельцевФайлов=ArrayOfFileOwners
МассивДоступныеТранспортыСообщений=ArrayOfAvailableMessageTransports
МассивЗависимыхПодсистем=ArrayOfDependentSubsystems
МассивЗависитОтПодсистем=ArrayDependsOnSubsystems
МассивОбработанныхПодсистем=ArrayOfProcessedSubsystems
МассивРежимов=ArrayOfModes
МассивЧисел=ArrayOfNumbers
МенеджерДляПолученияДатыПодписи=ManagerToGetDateSignatures
менеджеров=Managers
МенеджерПланаСчетов=ChartOfAccountsManager
МенеджерСервисаПоддерживаетМетодВАдресе=ServiceManagerSupportsMethodInAddress
МестаИспользованияВМассив=PlacesofUseInArray
МестоОткрытияПриИзменении=PlaceOfOpeningWhenChanging
МетаданныеВладельцаПрисоединенныхФайлов=MetadataOfTheOwnerOfAttachedFiles
МетаданныеВладельцаПрисоединенныхФайловОбъект=MetadataOfTheOwnerOfTheAttachedFilesObject
МетаданныеВосстанавливаемогоРасширения=MetadataOfExtensionBeingRestored
МетаданныеИмеющиеСсылкиНаТипыИсключаемыеИзВыгрузкиИТребующиеОбработки=MetadataThatHasReferencesToTypesThatAreExcludedFromUnloadingAndNeedToBeProcessed
МетаданныеОписание=MetadataDescription_SSLy
МетаданныеОпределяемогоТипаПрисоединенныйФайл=MetadataOfDefinedAttachedFileType
МетаданныеРодителяВложения=ParentMetadataAttachments
МетаданныеСтаройНастройки=MetadataOfOldSetting
МетаданныеУстановленногоРасширения=MetadataOfInstalledExtension
Метка=Label
МеткаВремениДанныхПроверкиПодписи=TimestampDataVerificationSignatures
МеткаВремениПодписи=TimestampSignatures
МетодВАдресеПоддерживается=MethodInAddressIsSupported
МетодВариантыЗагрузки=LoadingOptionsMethod
МетодИнформация=MethodInformation
МетодыКоманднаяПанель=MethodsCommandPanel
МиграцияНеДоступна=MigrationIsNotAvailable
МиграцияПриложенийОткрытьФорму=MigrationOfApplicationsOpenForm
Миллисекунд=Millisecond
МинимальныеВерсии=MinimumVersions
МинимальныйШагИзменений=MinimumStepChanges
МинутДо=MinutesTo
МногопоточныеОперацииДоступны=MultithreadedOperationsAvailable
МножительРазложения=Factorization
МодельКонфигурации=ConfigurationModel
модулей=Modules
МодульГруппыДоступа=AccessGroupModule
МодульГруппыЗначенийДоступа=AccessValueGroupModule
МодульДополнительныхПроверок=AdditionalChecksModule
МодульЗависимостиПравДоступа=AccessRightDependencyModule
МодульЗначенияГруппДоступа=ModuleAccessGroupValues
МодульИдентификаторыОбъектовМетаданных=ModuleMetadataObjectIds
МодульИнтеграцияСПлатежнымиСистемамиСлужебный=ModuleIntegrationWithPaymentSystemsService
МодульИнтеграцияСЦРПТ=ModuleIntegrationOfTheSRPT
МодульКольцаВычетов=ModulusOfResidueRing
МодульКонструкторФормул=ModuleConstructorFormula
МодульКонструкторФормулКлиент=ModuleConstructorFormulaClient
МодульКонструкторФормулСлужебный=ModuleFormulaConstructorUtility
МодульНаборыЗначенийДоступа=ModuleAccessValueSets
МодульНапоминанияПользователя=ModuleUserReminder
МодульНаследованиеНастроекПравОбъектов=ModuleInheritanceSettingsRightsObjects
МодульНастройкиПравОбъектов=ModuleSettingsRightsObjects
МодульОбновлениеИнформационнойБазы=ModuleUpdatingInfobase
МодульОнлайнОплаты=ModuleOnlinePayment
МодульОнлайнОплатыКлиент=ModuleOnlinePaymentCustomer
МодульОнлайнОплатыСлужебныйВызовСервера=ModuleOnlinePaymentServiceCallServer
МодульОнлайнОплатыСлужебныйКлиент=ModuleOnlinePaymentServiceClient
МодульОплатаСервиса=ServicePaymentModule
МодульОповещениеПользователейБТС=ModuleNotificationOfBTSUsers
МодульПараметрыОграниченияДоступа=ModuleParametersAccessRestrictions
МодульПередачаДанныхСервер=ModuleDataTransferServer
МодульПолучениеУведомленияОтОнлайнОплат=ModuleReceivingNotificationFromOnlinePayment
МодульПользователиСервиса=ServiceUsersModule
МодульПраваРолей=ModulePermissionsRoles
МодульПрофилиГруппДоступа=ModuleAccessGroupsProfiles
МодульРазмерПриложений=ModuleSizeOfApplications
МодульРасписанияРегламентныхЗаданий=TheModuleOfTheScheduleOfRoutineTasks
МодульСверкаВзаиморасчетовПлатежныеСистемы=ModuleReconciliationOfMutualSettlementsPaymentSystems
МодульСверкаВзаиморасчетовПлатежныеСистемыКлиент=ModuleReconciliationOfMutualSettlementsPaymentSystemsClient
МодульСводныеПриложения=ModuleSummaryApplications
МодульСервисКриптографииDSSASNКлиентСервер=ModuleServiceCryptographyDSSASNClientServer
МодульСообщенияВСлужбуТехническойПоддержки=TheModuleOfTheMessageToTheTechnicalSupportService
МодульСообщенияВСлужбуТехническойПоддержкиКлиент=TheModuleOfTheMessageToTheTechnicalSupportServiceClient
МодульТаблицыГруппДоступа=ModuleTableGroupAccess
МодульЭлектроннаяПодписьйКлиент=ModuleElectronicSignatureClient
МожноОтключать=CanBeDisabled
МоиЗаявленияВРаботе=MyStatementsInProgress
МоиСертификатыСИстекающимСрокомДействия=MyCertificatesWithexpiringValidity
МоментНачала=StartMoment
МоментСозданияРК=MomentOfCreationOfRepublicOfKazakhstan
МониторПортала1СИТС=PortalMonitor1CITS
Монопольные=Monopoly
МонопольныеОбработчики=ExclusiveHandlers
МультиязычнаяПодсистема=MultilingualSubsystem
МультиязычнаяСтрока=Multilingual_String
МультиязычныеОбъекты=MultilingualObjects
МультиязычныйРеквизит=MultilingualProps
НаборДанныхДляЗаполнения=DatasetToFill
НаборДополнительныхУсловий=SetAdditionalConditions
НаборЗаписейДанныеОбъектов=RecordsetObjectData
НаборЗаписейОповещений=AlertRecordset
НаборЗаписейПредупреждения=RecordSetWarnings
НаборЗаписейСоответствиеОбъектов=RecordSetMatchingObjects
НаборКлючей=SetOfKeys
НаборМультиязычныхРеквизитов=MultilingualPropsSet
НаборОбработчиков=SetOfHandlers
НаборОписанныйВКоде=SetDescribedInCode
НаборПараметровДляЗаполненияОбъекта=ParameterSetForFillingObject
НаборПараметровЗаполнения=SetFillSettings
НаборПараметровПроцедуры=ProcedureSettings
НаборПараметровФункции=FunctionSettings
НаборПолейВыборки=SelectionFieldSet
НаборПолейУпорядочивания=OrderFieldSet
НаборПрав=RightsSet
НаборУсловий=ConditionSet
НаборыРегистраторов=LoggerSets
НавигационнаяСсылкаСтроки=RowNavigationLink
НадписьВосстановленияПароляАвторизацияНажатие=TheInscriptionOfPasswordRecoveryAuthorizationPressing
НадписьЕстьНеПримененныеИсправленияОбработкаНавигационнойСсылки=InscriptionIsNotAppliedCorrectionsProcessingOfNavigationLink
НадписьЕстьОшибкиУчетаОбработкаНавигационнойСсылки=InscriptionThereAreAccountingErrorsProcessingNavigationLink
НадписьНетЛогинаИПароляАвторизацияНажатие=TheInscriptionNoLoginAndPasswordAuthorizationPressing
НадписьНеуспешноеИсправлениеОбработкаНавигационнойСсылки=InscriptionUnsuccessfulCorrectionProcessingOfNavigationLink
НадписьОграничениеПоВладельцуБезОптимизации=CaptionRestrictionOnOwnerWithoutOptimization
НадписьПоясненияПодключенияАвторизацияОбработкаНавигационнойСсылки=InscriptionExplainsConnectionAuthorizationProcessingOfNavigationLink
НаименованиеЗаданияЗаполненияПараметров=TaskNameFillingParameters
НаименованиеНаЯзыкеПользователя=NameInUserLanguage
НаименованиеПокупателя=BuyerSName
НаименованияЛокализуемыхРеквизитовШапки=NamesofLocalizableDetails
НайденаСтрока=IsFoundString
НайденВСпискеУдостоверяющихЦентров=FoundintheListofCAs
НайденнаяОбласть=FoundArea
НайденнаяЭлемент=FoundItem_
НайденныеОперанды=FoundOperands
НайденныеПрава=FoundPermissions
НайденныеРазличияКоманднаяПанель=DifferencesFoundCommandPanel
НайденныеРазличияПриАктивизацииСтроки=DifferencesFoundWhenActivatingString
НайденныеРазличияСостояниеПросмотра=DifferencesFoundViewingStatus
НайденныеРазличияСтрокаПоиска=DifferencesFoundSearchBar
НайденныеРазличияУправлениеПоиском=DifferencesFoundSearchManagement
НайденныеФайлыАрхиваДанных=FoundDataArchiveFiles
НайтиОбласть=FindArea
НайтиПараметрыВТексте=FindParametersInText
НайтиПолеВИерархии=FindFieldVIerarchy
НайтиСобытияНастроек=FindEventSettings
НаправлениеПередачиДанных=DataTransmissionDirection
НаследованиеНастроекВладельцем=InheritanceSettingsOwner
НаследованиеНастроекПоВладельцам=InheritanceSettingsByOwners
НастроенноеПраво=CustomizedRight
НастроенноеПравоДляПодпапок=SetRightForSubfolders
НастроитьВыгрузкуВСводноеПриложение=ConfigureUploadingToSummaryApp
НастроитьЗагрузкуВСводноеПриложение=ConfigureUploadingToSummaryApp_
НастроитьОтображениеИнтеграцииСЦентромМониторинга=ConfigureTheDisplayOfIntegrationWithTheMonitoringCenter
НастроитьПараметрПраво=ConfigureParameterRight
НастроитьПараметрУровеньДоступа=ConfigureParameterAccessLevel
НастроитьСозданиеКлючаДоступаДляЗависимыхСписковБезКлючей=ConfigureCreationOfAccessKeyForDependentListsWithoutKeys
НастроитьЭлементыТекущейСтраницыПриОткрытии=AdjustCurrentPageElementsOnOpening
НастройкаАутентификации=SettingUpAuthentication
НастройкаИнтеграции=Integration
НастройкаОтказаОтПредупреждения=WarningDisclaimerSetting
НастройкаПараметра=ParameterSetting
НастройкаСинхронизацииЧерезУниверсальныйФормат=SettingUpSynchronizationViaUniversalFormat
НастройкаУзла=ConfiguringNode
НастройкаЭлементовФормы=ConfiguringFormElements
НастройкиАвторизацииИнтернетСервиса=SettingsAuthorizationInternetService
НастройкиАвторизацииНаПочтовомСервере=SettingsAuthorizationOnMailServer
НастройкиАвторизацииОбъект=SettingsAuthorizationObject
НастройкиАвторизацииСервера=ServerAuthorizationSettings
НастройкиВходаВМоделиСервиса=ServiceModelLoginSettings
НастройкиЗаполнения=PopulationSettings
НастройкиИзКлассификатора=SettingsFromClassifier
НастройкиИзмененияЯзыков=SettingsChangesLanguages
НастройкиИнтеграции=IntegrationSettings
НастройкиОбменаДаннымиКоманднаяПанель=DataExchangeSettingsCommandPanel
НастройкиОбработки=ProcessingSettings
НастройкиОкнаВебКлиента=WebClientWindowSettings
НастройкиОкнаТонкогоКлиента=SettingsWindowThinClient
НастройкиОнлайнОплат=SettingsOnlinePayment
НастройкиОткрытияФайловКоманднаяПанель=FileOpeningSettingsCommandPanel
НастройкиПодключенияПоАдресуЭлектроннойПочты=ConnectionSettingsByEmailAddress
НастройкиПодключенияСервиса=SettingsConnectionService
НастройкиПодключенияСлужебнойУчетнойЗаписи=ServiceAccountConnectionSettings
НастройкиПодписания=SettingsSigning
НастройкиПодписи=SettingsSignatures
НастройкиПравИерархия=SettingsRightsHierarchy
НастройкиПравЛегенда=SettingsRightsLegend
НастройкиПравПоВладельцам=RightsSettingsByOwners
НастройкиПравПоОбъектам=RightsSettingsOnObjects
НастройкиПравПоТаблицеВОтборе=SettingsRightsByTableInselection
НастройкиРазделаПроизводительность=SettingsSectionPerformance
НастройкиСлужебнойУчетнойЗаписи=ServiceAccountSettings
НастройкиСлужебнойУчетнойЗаписиДляУсовершенствованияПодписей=ServiceAccountSettingsToImproveSignatures
НастройкиТаблицыЗначенийКоманднаяПанель=SettingsOfTableOfValuesCommandPanel
НастройкиТаблицыЗначенийПередНачаломДобавления=SettingsOfTableOfValuesBeforeAdding
НастройкиТаблицыЗначенийПередУдалением=SettingsOfTableOfValuesBeforeDeletion
НастройкиТаблицыЗначенийСостояниеПросмотра=ValueTableSettingsViewStatus
НастройкиТаблицыЗначенийСтрокаПоиска=ValueTableSettingsSearchString
НастройкиТаблицыЗначенийУправлениеПоиском=ValueTableSettingsSearchManagement
НастройкиТранспортаОбменаНовогоУзла=NewNodeExchangeTransportSettings
НастройкиТранспортаОбменаСтарогоУзла=TransportSettingsForOldNode
НастройкиУзловИБНовогоУзла=SettingsOfNewNodeSIBNodes
НастройкиУзловИБСтарогоУзла=SettingsOfIBNodesOfOldNode
НастройкиФорматаПолей=FieldFormatSettings
НачалоВторойСтроки=StartOfSecondLine
НачалоЗапроса=RequestStart
НачалоКонтроляУдаленияПомеченных=BeginningOfControlOfRemovalOfMarked
НачалоОбновления=StartUpdates
НачалоОшибки=StartErrors
НачалоПозиции=StartOfPosition
НачалоПроцедуры=BeginningOfProcedure
НачалоФункции=StartOfFunction
НачальнаяРоль=InitialRole
НачальнаяЯчейка=StartCell
НачальноеЗаполнениеТЧПредставления=InitialFillingPMViews
НачальноеЗначениеЕстьПравоСОграничением=InitialValueIsRightWithRestriction
НачальноеЗначениеРеквизита=PrimaryAttributeValue
НачальныйКлючВарианта=InitialOptionKey
НачальныйОбразСформирован=InitialImageFormed
НачальныйОтбор=InitialSelection
НачальныйОтборУстановлен=InitialSelectionSet
НачатьАктивациюКодаРегистрации=StartActivatingRegistrationCode
НачатьВходВСервис=StartLoggingInToService
НачатьВыгрузкуДанных=StartUploadingData
НачатьВыполнениеМетодаИнтерфейса=StartExecutingInterfaceMethod
НачатьВыполнениеФоновогоЗаданияНаСервере=StartBackgroundJobOnServer
НачатьДобавлениеАрхивнойМеткиВремени=GetStartedAddinganArchivedTimestamp
НачатьЗагрузкуДанныхТекущейОбластиИзАрхива=StartLoadingCurAreaDataFromArchive
НачатьЗагрузкуТарифовСервиса=StartLoadingServiceRates
НачатьЗаменуСсылок=StartReplacingLinks
НачатьЗапросАктивации=StartActivationRequest
НачатьЗапросПоиска=StartSearchQuery
НачатьЗапросПоКодуАктивации=StartRequestByActivationCode
НачатьЗапросПоНастройкам=StartRequestBySettings
НачатьЗапросРегистрации=StartRegistrationRequest
НачатьИнициализациюОповещение=StartInitializationAlert
НачатьОпределениеМестИспользования=StartDeterminingUseLocations
НачатьОтправку=StartSending
НачатьОтправкуВЛогическоеХранилище=StartSendingToLogicalStorage
НачатьОтправкуПредупреждений=StartSendingAlerts
НачатьПередачуДанных=StartDataTransfer
НачатьПередачуФайла=StartFileTransfer
НачатьПоискОрганизаций=StartSearchingForBusinesses
НачатьПолучениеКонтейнераПодписейКриптографии=StartReceivingTheCryptographySignatureContainer
НачатьПроверкуПочты=StartCheckingMail
НачатьРегистрациюВСервисе=StartRegisteringInService
НачатьСопоставлениеПользователей=StartMatchingUsers
НачатьСоставнуюЗагрузку=StartMultipartUpload
НачатьУсовершенствованиеНаСервере=StartImprovementOnServer
НачатьУсовершенствованиеПодписи=GetStartedImprovementSignatures
НачПериода=BegPeriod
НашлиРесурс=FoundResource
Не\ [СуммаВключаетНДС]=Not[AmountIncludesVAT]
НеВыгружатьОбъект=NotExportObject
НеВыполнятьПриПереходеСДругойПрограммы=DoNotExecuteWhenSwitchingFromAnotherProgram
НедоступныеПараметры=UnavailableOptions
НеЗавершаетсяБесплатных=NotCompletedFree
НеЗавершаетсяВсего=NotTotalCompleted
НеЗавершаетсяПлатных=NotEndingPaid
НеЗавершаетсяТестовых=NotTestResultsAreCompleted
НеЗаменять=DoNotReplace
НезаполненныеРеквизиты=BlankAttributes
НеЛюбой=NotAny
НеЛюбойПорядок=NotAnyOrder
НеобработанныеПодписи=rawsignatures
НеобходимоЗафиксироватьЗавершениеНастройкиСинхронизации=YouMustRecordCompletionOfSynchronizationSettings
Неотрицательное=Non_negative
НеподтвержденнаяДатаПодписи=UnconfirmedSignatureDate
НеподтвержденноеВремяПодписи=UnconfirmedTimeSignatures
НеПредупреждатьОБольшомРазмереОтчета=DontWarnAboutLargeReportSize
НепринятыеДанныеКоллизии=RejectedCollisionData
НепринятыйНовый=RejectedNew
НепринятыйСуществующий=UnrecognizedExisting
НепросмотренноеВзаимодействие=UnsolicitedInteraction
НерабочиеПериодыКоманднаяПанель=NonWorkingPeriodsCommandPanel
НетПользователейСАдминистративнымиПравами=NoUsersWithAdministrativeRights
НеТребуетсяПродление=NotRequiredExtension
НетФайлаВТоме=NoFileInVolume
НеУказанПредставление=UnspecifiedRepresentation
НижняяЧасть=BottomPart
НизОбласти=BottomOfArea
НоваяЗаписьДанныеОбъектов=NewRecordObjectData
НоваяЗаписьНастроек=NewSettingsEntry
НоваяНастройкаОбъект=NewObjectSetting
НоваяСтрокаОрганизации=NewBusinessLine
НоваяСтрокаТЗ=NewLineOfVT
НоваяСтрокаТЧПредставления=NewStringPchRepresentation
НоваяТаблицаПрофилей=NewProfileTable
НоваяЧасть=NewPart
НовоеВзаимодействие=NewInteraction
НовоеИмяПоля=NewFieldName
НовоеИмяРасширения=NewExtensionName
НовоеОписаниеНастроекВхода=NewDescriptionOfLoginSettings
НовоеТекущее=NewCurrent
НовыеОбъекты=NewObjects
НовыеОбъектыМетаданных=NewMetadataObjects
НовыеПараметрыПодписиКриптографии=NewSettingsSignaturesCryptography
НовыеСвойстваНабора=New_SetProperties
НовыеСвойстваПараметраОбновления=NewUpdateParameterProperties
НовыеСвойстваПодписи=NewSignatureProperties
НовыеСвойстваРегистров=NewRegisterProperties
НовыеХешСуммыСвойствВидовДоступа=NewHashSumAccessTypeProperties
НовыйВладелец=NewOwner
НовыйГлавныйУзел=NewMasterNode
НовыйДополнительныеСведения=NewAdditionalInformation
НовыйДопСведенияАбонента=NewAdditionalSubscriberInformation
НовыйЗаголовокПодразделений=NewDivisionHeading
НовыйЗаголовокСкладов=NewWarehouseTitle
НовыйИдентификаторРасширения=NewExtensionId
НовыйКонецКаталога=NewEndOfDirectory
НовыйКонецКаталога64=NewEndOfDirectory64
НовыйЛокатор64=NewLocator64
НовыйОсновныеСвойстваОтвета=NewBasicResponseProperties
НовыйОтборПодписокНаТарифы=NewPricingPlanSubscriptionSelection
НовыйОтборСчетовНаОплату=NewSelectionOfInvoicesForPayment
НовыйПараметрыПодтвержденияЗадачи=NewTaskConfirmationParameters
НовыйПараметрыПолученияТалонаНаЗагрузкуФайла=NewOptionsForGettingFileUploadCoupon
НовыйПараметрыСозданияОбновленияУчетнойСистемыБиллинга=NewSettingsForCreatingUpdatingBillingAccountSystem
НовыйРезультатДлительнойОперации=NewResultLongOperation
НовыйРезультатОбработки=NewProcessingResult
НовыйРеквизитВРоли=NewAttributeInRole
НовыйСоставнаяЗагрузка=NewMultipartUpload
НовыйТарифыСчетаНаОплату=NewPaymentInvoiceNumber
НовыйТелефонИзменениеТекстаРедактирования=NewPhoneEditTextChange
НовыйТелефонПриИзменении=NewPhoneOnChange
НовыйТипПодписи=NewSignatureType
НовыйУслугиСчетаНаОплату=NewInvoiceNumber
НовыйФайлыСчетаНаОплату=NewInvoiceFile
НовыйШаблонПодпискиНаОсновнойТариф=NewSubscriptionTemplateForBasicPlan
НовыйШаблонПодпискиНаРасширениеТарифа=NewSubscriptionTemplateForTariffExpansion
НовыйШаблонСчетаНаОплату=NewInvoiceTemplate
НомераСеансовИменаПользователей=SessionNumbersUserNames
НомерГТДДокумента=GTDDocumentNumber
НомерИмени=NameNumber
НомерКартинкиПоВзаимодействию=InteractionImageNumber
НомерОбластиДанных=DataRegionNumber
НомерОснования=NumberOfBaseDocument
НомерПриложения=ApplicationNumber
НомерРесурсаСтрокой=ResourceNumberAsString
НомерСтрокиТаблицы=TableRowNumber
НомерСтрокиЭлемента=NumberLineItem
НормализоватьАдрес=NormalizeAddress
НП=NP
НРазряда=NDischarge
НЧасти=NParts
НЧисла=NNumbers
ОбластиДляОбработки=AreasToProcess
ОбластиМакета=TemplateAreas
ОбластиПерсональныхДанных=AreasOfPersonalData
ОбластиСУсловиями=Areaswithconditions
ОбластиТаблиц=AreasTables
ОбластьДанных=DataArea
ОбластьДействияРазделение=ScopeSeparation
ОбластьНиже=RegionLower
ОбластьОбъекта=ObjectScope
ОбластьРоли=ScopeRoles
ОбластьСлева=AreaLeft
ОбластьСправа=AreaOnRight
ОбластьСтрок=RowArea_
ОбластьШтампа=StampArea
ОбменУП2ЗУП3=ExchangeUP2ZUP3
ОбновитьАктивностьПользователяСервиса=UpdateActivityOfServiceUser
ОбновитьАктуальностьРасчетаПриложения=UpdateRelevanceOfAppCalculation
ОбновитьВидимостьГруппыРазмераПриложения=UpdateAppSizeGroupVisibility
ОбновитьВидимостьПредупреждения=RefreshVisibilityWarnings
ОбновитьВидимостьЭлементаВводитьПарольВПрограммеЭлектроннойПодписи=UpdateItemVisibilityEnterPasswordInElectronicSignatureProgram
ОбновитьВстроенныйКриптопровайдер=UpdatetheBuiltInCryptoprovider
ОбновитьВыполнениеРасчетаПриложения=UpdateApplicationCalculationExecution
ОбновитьГруппыИНаборыЗначенийДоступаПриИзмененииТиповГруппИЗначений=UpdateGroupsAndSetsOfAccessValuesWhenGroupTypesAndValuesChange
ОбновитьДанныеСертификата=UpdateCertificateInformation
ОбновитьДопРеквизитыПользователяАбонента=UpdateAdditionalDetailsOfSubscriberSUser
ОбновитьДопСведенияАбонента=UpdateAdditionalSubscriberInformation
ОбновитьДопСведенияОбслуживаемогоАбонента=UpdateAdditionalInformationOfServedSubscriber
ОбновитьИдентификаторЗаполнения=UpdateFillId
ОбновитьИзФайлаНаДискеСтараяВерсия=UpdateFromFileOnDiskOldVersion
ОбновитьИнформациюОНезаписанныхПравилах=UpdateInformationAboutUnwrittenRules
ОбновитьИнформациюОРасчетеРазмераПриложения=UpdateInformationAboutAppSizeCalculation
ОбновитьИнформациюПоПроблемам=UpdateInformationOnIssues
ОбновитьКлассификатор=UpdateClassifier
ОбновитьКонфигурациюПриИзменении=UpdateConfigurationWhenChanging
ОбновитьМенюПереходаМеждуИзменениямиНастроек=RefreshJumpMenuBetweenSettingChanges
ОбновитьНаименованиеВстроенногоКриптопровайдера=UpdateNameOfBuiltInCryptoprovider
ОбновитьНепоставляемыеПрофили=UpdateUnshippedProfiles
ОбновитьНепоставляемыеПрофилиПоИзменениямКонфигурации=UpdateNonSuppliedProfilesOnConfigurationChanges
ОбновитьОбластьНастройкиВыбранныхЯчеек=UpdateAreaSettingsSelectedCells
ОбновитьОтображениеМакета=UpdateDisplayLayout
ОбновитьПлатформуПриИзменении=UpdatePlatformWhenChange
ОбновитьПолеВводаЗначенияТекущейЯчейки=UpdateInputFieldCurrentCellValue
ОбновитьПоПорядковомуНомеру=UpdateByOrderNumber
ОбновитьПредопределенныеВидыКонтактнойИнформацииФизическихЛиц=UpdatePredefinedTypesOfContactInformationOfIndividuals
ОбновитьПредставлениеДанных=UpdateDataView
ОбновитьРасписаниеЗагрузкиИсправлений=UpdateThePatchDownloadSchedule
ОбновитьСведенияОбИспользованииПароля=UpdatePasswordUsageInformation
ОбновитьСостояние=RefreshStatus
ОбновитьСочетаниеКлавишКомандПереходаМеждуИзменениямиНастроек=UpdateKeyboardCommandTransitionBetweenSettingChanges
ОбновитьСписокСертификатовПослеПолученияСвойствСертификатовНаКлиенте=UpdateCertificateListAfterGettingCertificatePropertiesOnClient
ОбновитьСтатусПереходаВСервис=UpdateStatusOfTransitionToService
ОбновитьСтатусСопоставленияПользователей=UpdateUserMappingStatus
ОбновитьТекстВОбластиЯчеек=UpdateTextInCellsArea
ОбновитьТокенДоступа=RefreshAccessToken
ОбновитьТолькоМультиязычныеСтроки=UpdateMultilingualStringsOnly
ОбновитьУсовершенствованнуюПодпись=UpdateAdvancedSignature
ОбновитьШтрихкодBase64=UpdateBase64Barcode
ОбновлениеВерсииИБ_ОбъектЗаблокирован=IBVersionUpdate_ObjectLocked
ОбновлениеИнтерфейса=InterfaceUpdate
ОбновлениеИнформационнойБазыПроблемаСДанными=InfoBaseUpdateProblemWithData
ОбновлениеРазделенногоКлассификатора=UpdatingTheSplitClassifier
ОбновлениеРазделенныхДанныхНеРазделенногоКлассификатора=UpdatingTheSplitDataOfANonSplitClassifier
ОбновленныеВозможныеПраваДляНастройкиПравОбъектов=UpdatedPossibleRightsForSettingRightsObjects
ОбновленныеНепоставляемыеПрофили=UpdatedUnshippedProfiles
ОбновленныеПоставляемыеПрофили=UpdatedSuppliedProfiles
ОбрабатываемыеОбъекты=ObjectsToProcess
ОбрабатываемыеПодсистемы=ProcessedSubsystems
ОбработаннаяСтрока=ProcessedString_
ОбработанныеДублиПредопределенных=ProcessedDuplicatesOfPredefined
ОбработанныеОбласти=TreatedAreas
ОбработанныеСеансы=ProcessedSessions
ОбработанныеЯчейки=ProcessedCells
ОбработатьДатыЗапретаИзменения=ProcessDatesWhenChangesAreBanned
ОбработатьЗаявленияИОповещенияСертификатов=ProcessApplicationsAndCertificateAlerts
ОбработатьКомандуВФормеМонитора=ProcessACommandInTheFormOfAMonitor
ОбработатьНавигационнуюСсылкуВФормеМонитора=ProcessANavigationLinkInTheFormOfAMonitor
ОбработатьНавигационнуюСсылкуКлассификатора=HandleNaviLinkClassifier
ОбработатьНастройкиТранспортаСообщенийОбмена=ProcessExchangeMessageTransportSettings
ОбработатьОбщиеДанныеДляПереходаНаНовуюВерсию=ProcessGeneralDataToUpgradeToNewVersion
ОбработатьОповещениеОбИзмененииОбъекта=ProcessObjectChangeNotification
ОбработатьПрерваннуюПроцедуруЗагрузки=HandleInterruptedBootProcedure
ОбработатьРезультатыОбменаДанными=ProcessDataExchangeResults
ОбработатьСоответствияОбъектовИнформационныхБаз=CheckCorrespondenceOfInformationDatabaseObjects
ОбработатьСсылкуНаИсключаемыйИзВыгрузкиОбъект=ProcessReferenceToObjectToExcludeFromUploading
ОбработатьСсылочныеОбъекты=HandleReferenceObjects
ОбработатьСценарииОбменовДанными=HandleDataExchangeScenarios
ОбработкаНавигационнойСсылкиОткрытиеНастроекЭП=ProcessingNavigationLinkOpeningSettingsES
ОбработкаНавигационнойСсылкиСПАРКРиски=ProcessingOfTheSPARKNavigationLinkRisks
ОбработкаОповещенияСПАРКРиски=HandlingSPARKAlertRisks
ОбработкаПереходов=TrafficHandling
ОбработкаСсылокНаТипыИсключаемыеИзВыгрузки=HandlingReferencesToTypesExcludedFromUnloading
ОбработчикВопросаВыполненияРасчета=HandlerForCalculationIssue
ОбработчикДлительнойОперацииВыполнитьОбновлениеНеразделенныхДанных=LongOperationHandlerPerformUpdateUnsharedData
ОбработчикДлительнойОперацииВыполнитьОбновлениеРазделенныхДанных=LongOperationHandlerPerformUpdateSplitData
ОбработчикиИНовыеОбъекты=HandlersNewObjects
ОбработчикиКоманд=CommandHandlers
ОбработчикиКонвертации=ConversionHandlers
ОбработчикиНачальногоЗаполнения=InitialFillHandlers
ОбработчикиОшибки=HandlersErrors
ОбработчикиСПроблемами=HandlersWithProblems
ОбработчикНачальногоЗаполненияПредопределенных=InitialFillHandlerPredefined
ОбработчикОжидания=WaitHandler
ОбработчикОжиданияПоказатьСостояниеСертификата=WaitHandlerShowCertificateStatus
ОбработчикПерехода=TransitionHandler
ОбработчикПроверкиВеденияУчета=AccountingCheckHandler
ОбработчикУстановитьКурсорВШаблонеТекста=HandlerSetCursorInTextTemplate
ОбратныйМодуль=ReverseModule
ОбратныйПорядок=reverseorder
ОбратныйТипГруппыПользователей=ReverseUserGroupType
ОбратныйТипПользователя=ReverseUserType
ОбращениеОбъект=SupportRequestObject
ОбращенияНадписьЕстьОтвет=HitsLabelAnswerExists
ОбслуживаемыеАбоненты=ServedSubscribers
ОбслуживающиеОрганизацииСайт=ServiceCompaniesWebsite1
ОбщаяФормаРазрешенныеНеаккредитованныеУЦОткрыть=GeneralFormAllowedNonAccreditedUSOpen
ОбщееИмя=CommonName
ОбщиеНастройкиУзлов=GeneralSettingsNodes
ОбщиеРеквизиты=CommonAttributes
ОбщиеРеквизитыПечатныхФорм=GeneralDetailsofPrintedForms
ОбщийРазмерФайловОптимален=TotalFileSizeIsOptimal
ОбъединитьОшибкиДанныхСертификата=MergeCertificateDataErrors
объекта=Object_
ОбъектАнглийскийЯзык=ObjectEnglishLanguage
ОбъектКонфигурации=ConfigurationObject
ОбъектМетаданныхМакета=ObjectMetadataLayout
ОбъектМетаданныхСФайламиПриИзменении=MetadataObjectWithFilesWhenModified
ОбъектМетаданныхТаблицы=TableMetadataObject
объектов=Objects_
ОбъектРасширенияВходитВСоставПланаОбмена=ExtensionObjectIsPartOfExchangePlan
ОбъектСМультиязычнымиРеквизитами=ObjectWithMultilingualAttributes
ОбъектСодержитТЧПредставления=ObjectContainsPMRepresentations
ОбъектыБезПрав=ObjectsWithoutRights
ОбъектыИсключенияПланаОбменаРИБ=ObjectsExchangePlanExchangeRIB
ОбъектыМетаданныхТребующиеОбработки=MetadataObjectsToBeProcessed
ОбъектыНазначенияКоманднаяПанель=DestinationObjectsCommandPanel
ОбъектыСМультиязычнымиРеквизитами=ObjectsWithMultilingualAttributes
ОбъектыСТабличнойЧастьюПредставлениеКОбработке=ObjectsTablePartViewToProcess
ОбъектыСТЧПредставления=ObjectsSCHRepresentations
ОбязательныеСведенияДляОформленияПодписки=RequiredInformationForSubscribing
ОбязательныеСвойства=RequiredProperties_
Обязательных=Mandatory
ОграничениеБезКомментария=RestrictionWithoutComment
ОГРНИП=REGNUMIE
ОдинВладелецНастроек=OneOwnerSettings
ОдинПользовательВТабличнойЧасти=OneUserInTableSection
ОМДРасширения=OMDExtensions
ОперандыИФункции=OperandsAndFunctions
ОперандыСтроки=StringOperands
ОперандыФормулыРасчетаКурса=OperandsFormulasCalculationCourse
ОперативныеОбработчики=OperationalHandlers
ОператорыФормулыРасчетаКурса=OperatorsFormulasCalculationCourse
ОписаниеВидаСравнения=DescriptionComparisonType
ОписаниеВидКонтактнойИнформации=DescriptionKindContactInformation
ОписаниеВозможныхПравСеансаДляНастройкиПравОбъектов=DescriptionPossibleSessionRightsForSettingObjectRights
ОписаниеИдентификатораРоли=RoleIdDescription
ОписаниеИдентификаторовРолей=DescriptionIdsRole
ОписаниеКолонкиДляПодпапок=DescriptionColumnsForSubfolders
ОписаниеОжидания=DescriptionOfWaiting
ОписаниеОтвета=ResponseDescription
ОписаниеОшибкиАвторизацииПочтовогоСервера=DescriptionErrorsMailServerAuthorization
ОписаниеОшибкиПриУсовершенствовании=DescriptionBugsUpgraded
ОписаниеПоставляемыхПрофилейСеанса=DescriptionSuppliedSessionProfiles
ОписаниеПредыдущейПодсистемы=DescriptionPreviousSubsystem
ОписаниеПроверки=VerificationDescription
ОписаниеПрофилей=DescriptionProfiles
ОписаниеРасширенийДляЖурнала=DescriptionExtensionsForJournal
ОписаниеРолейБезПрав=DescriptionRolesWithoutPermissions
ОписаниеСвойствВидовДоступаСеанса=DescriptionPropertiesAccessTypesSession
ОписаниеСостояния=StateDescription
ОписаниеСтандартныхРолейРасширений=DescriptionStandardRolesExtensions
ОписаниеСтандартныхРолейРасширенийСеанса=DescriptionStandardRolesSessionExtensions
ОписаниеСтрок=DescriptionStrings
ОписаниеТиповЗначенийДополнительныхСведений=DescriptionOfValueTypesForAdditionalInformation
ОписаниеТиповИзКлючейСоответствия=TypeDescriptionFromMatchKeys
ОписаниеУровня=LevelDescription
ОписанияИсточниковДанных=DataSourceDescriptions
ОписанияНастроек=DescriptionsOfSettings
ОписанияТипов=TypeDescriptions
ОписанияТиповИсключаемыхИзВыгрузкиЗагрузки=DescriptionsOfTypesExcludedFromUploadingDownloads
оплату=Payment_0
Оплачен=Paid
ОповещениеОЗакрытииЗаявления=NotificationClosedStatements
ОповещениеПередПомещением=NotificationBeforePlacement
ОповещениеПриЗавершении=NotificationOnCompletion
ОпределениеДанныхВыбораЭлементаОтбора=DefiningSelectionItemSelectionData
ОпределитьАдресЭлектроннойПочтыПользователя=DetermineUserSEmailAddress
ОпределитьДанныеВыбораЭлементаОтбораПоЗапросу=DefineFilterItemSelectionDataOnQuery
ОпределитьДоступностьКомандПереходаМеждуИзменениямиНастроек=DetermineAvailabilityofTransitionCommandsBetweenSettingsChanges
ОпределитьИдентификаторыВходящегоСообщения=DetermineIncomingMessageIDs
ОпределитьПоддерживаемыеБазыВФонеЗавершение=DefineSupportedBasesInBackgroundEnd
ОпределитьПорядокСертификатов=DetermineOrderOfCertificates
ОпределитьСостояниеПодключенияВФоне=DetermineConnectionStateInBackground
ОпределитьСостояниеПодключенияВФонеОжидание=DetermineConnectionStateInPendingBackground
ОпределитьСхемуСсылки=DefineLinkScheme
ОпределитьТему=DefineTheme
ОпределитьТипПодписейОбъекта=DetermineTypeSignaturesObject
ОпределитьЯзыкВерсии=DefineVersionLanguage
ОрганизацииSearchControl=SearchControlCompanies
ОрганизацииSearchControlContextMenu=OrganizationsSearchControlContextMenu
ОрганизацииSearchString=OrganizationsSearchString
ОрганизацииSearchStringContextMenu=OrganizationsSearchStringContextMenu
ОрганизацииViewStatus=OrganizationsViewStatus
ОрганизацииViewStatusContextMenu=OrganizationsViewStatusContextMenu
ОрганизацииВключитьВсеОрганизации=CompaniesIncludeAllCompanies
ОрганизацииКоманднаяПанель=CompaniesCommandBar
ОрганизацииОтключитьВсеОрганизации=CompaniesDisableAllCompanies
ОрганизацииСтрокаПоиска=CompaniesSearchString
ОрганизацииУправлениеПоиском=CompaniesSearchControl
ОрганизацияОтборПриИзменении=CompanyFilterOnChange
ОригинальныйIDСообщенияMicrosoft=OriginalIDMessageMicrosoft
основании=BasedOn
ОсновнаяОрганизацияОчистка=MainCompanyCleaning
ОсновнаяОрганизацияПриИзменении=MainOrganizationWhenChanging
ОсновнаяОчередь=MainQueue
ОсновнаяОчередьОбъект=MainQueueObject
ОсновнойОбработчик=MainHandler
ОсновнойУзел=MainNode
ОсновнойЯзыкИзменен=MainLanguageChanged
ОсновныеНепоставляемыеПрофили=BasicNonSuppliedProfiles
ОсновныеПараметрыМетода=MainParametersOfMethod
ОсновныеСвойстваОтвета=BasicResponseProperties
Осталось=Left
ОтборАвторИзмененияПриИзменении=FilterChangeAuthorOnChange
ОтборДляВнешнихПользователей=SelectionForExternalUsers
ОтборКлючВариантаБезУсловий=SelectionOptionKeyWithoutConditions
ОтборОрганизацияПриИзменении=FilterOrganizationOnChange
ОтборПоДействующим=SelectionByOperating
ОтборПользователь=SelectionUser
ОтборПоПоставщику=SelectionBySupplier
ОтборПоСтатусуЗаказаОчистка=SelectionByOrderStatusCleaning
ОтборПоСтатусуЗаказаПриИзменении=SelectionByOrderStatusInCaseOfChange
ОтборПрофилей=ProfileSelection
ОтборРегистраторПриИзменении=FilterRecorderOnChange
ОтборРоли=SelectionRole
ОтборСостояниеНачалоВыбора=FilterStateStartChoice
ОтборСостояниеОбработкаВыбора=FilterStateChoiceProcessing
ОтборСостояниеОчистка=FilterStateClearing
ОтборСсылка=FilterRef
ОтборСчетовНаОплату=SelectingInvoicesForPayment
ОтборСчетПриИзменении=FilterAccountOnChange
ОтборФизическоеЛицоПриИзменении=FilterIndividualOnChange
ОтборыПередВыборомПоля=QualifiersBeforeSelectField
ОтветЗапросаСчетаНаОплату=ResponseToInvoiceRequest
ОтветОшибка=ErrorResponse
ОтветственныеЛицаОрганизацийВывестиСписок=ResponsiblePersonsOfCompaniesDisplayAList
ОтветственныеЛицаОрганизацийКоманднаяПанель=ResponsiblePersonsOfOrganizationsCommandPanel
ОтветственныеЛицаОрганизацийНайти=ResponsiblePersonsOfCompaniesToFind
ОтветственныеЛицаОрганизацийОтменитьПоиск=ResponsiblePersonsOfCompaniesCancelTheSearch
ОтветственныеЛицаОрганизацийПоказатьМножественноеВыделение=ResponsiblePersonsOfCompaniesShowMultipleSelection
ОтветственныеЛицаОрганизацийСостояниеПросмотра=ResponsiblePersonsOfCompaniesViewingStatus
ОтветственныеЛицаОрганизацийСтрокаПоиска=ResponsiblePersonsOfCompaniesSearchBar
ОтветственныеЛицаОрганизацийУправлениеПоиском=ResponsiblePersonsOfCompaniesSearchManagement
ОтделитьЧасть=SeparatePart
ОтключенныеПодсистемыКоманднаяПанель=DisabledSubsystemsCommandPanel
ОтключенныеПодсистемыОтключенаПриИзменении=DisabledSubsystemsDisabledWhenChanging
ОтключитьГруппировки=DisableGroups
ОтключитьЗаполнениеПараметровРаботыРасширений=DisableFillingExtensionsWorkParameters
ОтключитьИОчиститьИсториюДанных=DisableAndClearDataHistory
ОтключитьОбработчикОбновленияСтатусаПереходаВСервис=DisableServiceStatusUpdateHandler
ОтключитьСтандартнуюОбработку=DisableStandardProcessing
ОткрытьВзаимодействиеВСлужбуПоддержки=OpenInteractionWithSupport
ОткрытьВыборФайла=OpenFileSelection
ОткрытьЗаписьДанныхНачальногоОбраза=OpenRecordInitialImageData
ОткрытьМенюВыбораСостоянияЗавершениеМассив=OpenStatusSelectionMenuCompletionArray
ОткрытьМенюВыбораСостоянияЗавершениеСтруктура=OpenStatusSelectionMenuCompletionStructure
ОткрытьНепросмотренныеВзаимодействия=OpenUnseenInteractions
ОткрытьОбращениеВСлужбуПоддержки=OpenSupportRequest
ОткрытьОбъектРасширения=OpenExtensionObject
ОткрытьОтчетПродлениеСрокаДействияЭлектронныхПодписей=OpenReportExtendValidityofElectronicSignatures
ОткрытьСертификатПослеВыбораИзСписка=OpenCertificateAfterSelectionFromList
ОткрытьСписокОбращенийВУСП=OpenListOfWUSPRequests
ОткрытьСписокПрограмм=OpenProgramList
ОткрытьСсылку=OpenLink
ОткрытьСтандартнуюФорму=OpenStandardForm
ОткрытьФормуВводаКодаПользователя=OpenUserCodeEntryForm
ОткрытьФормуВыбораТарифа=OpenFareSelectionForm
ОткрытьФормуОплатыСервиса=OpenServicePaymentForm
ОткрытьФормуОповещенияОНеобходимостиЗаменыСертификата=OpenNotificationFormNeedReplaceCertificate
ОткрытьФормуОтправкиСообщенияВСлужбуПоддержки=OpenFormForSendingMessageToSupportService
ОткрытьФормуПодключенияКУСП=OpenCuspActivationForm
ОткрытьФормуПомощникаНастроек=OpenHelpFormSettings
ОткрытьФормуПродленияДействияПодписей=OpenRenewalFormActionsSignatures
ОткрытьФормуШаблонаСообщенийСОтбором=OpenFormMessageTemplateWithSelection
Отладка=Debug
Отладка_ВыгрузкаНеДоступна=Debugging_UnloadingIsNotAvailable
Отладка_КонфигурацияНеПоддерживается=Debugging_ConfigurationNotSupported
Отладка_МиграцияДоступна=Debugging_MigrationIsAvailable
Отладка_МиграцияНеДоступна=Debugging_MigrationNotAvailable
Отладка_ОтсутствуютОбслуживающиеОрганизации=Debugging_NoServiceOrganizationsAvailable
Отладка_ПриглашениеДляРегистрацииНеДоступно=Debugging_NoRegistrationPromptAvailable
Отладка_УвеличиласьВерсияОбработки=Debugging__ProcessingVersion
ОтладкаПереходаВОблако=DebuggingTransitionToCloud
ОтложенноеОбновлениеПерезапущено=DeferredUpdateRestarted
ОтложенныеНаборы=DeferredSets
ОтменитьИзменениеПочтыНажатие=CancelEmailChangeClick
ОтменитьИзменениеТелефонаНажатие=CancelPhoneNumberChangeClick
ОтменитьПодключениеНаСервере=CancelConnectionOnServer
ОтменитьПодключениеПриПроверкеОтвета=CancelConnectionWhenCheckingResponse
ОтменитьПроверкуТелефонаНажатие=CancelPhoneNumberConfirmationClick
ОтменитьСоставнуюЗагрузку=CancelMultipartUpload
ОтметитьЗаполнениеПараметровРаботыРасширений=MarkFillingOptionsExtensionsWork
ОтметитьРегистрациюДанных=MarkRegisterData
ОтметитьЭлементКакОригинал=MarkItemAsOriginal
ОтображаемыеПоля=DisplayedFields
ОтображатьЗаголовокОписания=DisplayDescriptionTitle
ОтображатьКнопкуЗапуска=DisplayStartButton
ОтображениеСпискаПриИзменении=ListDisplayOnChange
ОтобразитьДополнительныеДанныеМонитора=DisplayAdditionalMonitorData
ОтписатьсяОтОповещенияОбИзмененииОбъекта=UnsubscribeFromObjectChangeNotifications
ОтправитьPUT=SendPUT
ОтправитьДанныеВМенеджерСервиса=SendDataToServiceManager
ОтправитьЗапросВСервисИзЛокальнойБазы=SendRequestToServiceFromLocalDatabase
ОтправитьОтветВУчетнуюСистемуБиллинга=SendResponseToBillingSystem
ОтправитьПредупрежденияНаСервере=SendAlertsToServer
ОтправитьСообщениеВСервис=SendMessageToService
ОтправитьСообщениеСервер=SendMessageServer
ОтправитьЧастьФайла=SendPartOfFile
ОтправитьЧастьФайлаDT=SendPartOfDTFile
ОтправитьЧастьФайлаS3=SendPartOfS3File
ОтправитьЧастьФайлаВЛогическоеХранилище=SendPartOfFileToLogicalStorage
ОтправлениеСообщенияВСлужбуПоддержки=SendingMessageToSupport
ОтправлятьЗаголовокIfModifiedSinceПриИзменении=SendIfModifiedSinceHeaderWhenChangeIsMade
ОтсутствуютОбслуживающиеОрганизации=ThereAreNoServiceOrganizations
ОтсутствующиеСвойства=MissingProperties
ОтчетПрогрессОбновления=UpdateProgressReport
ОтчетыИсключаемыеИзПроверкиПодключенияКХранилищу=ReportsExcludedFromConnectionCheckToStorage
ОтчетыИсключаемыеИзПроверкиХранилищаВарианта=ReportsExcludedFromCheckStorageVariant
ОформитьПолеПароля=CheckoutPasswordField
ОформитьТаблицуЗначенияДоступаВФорме=CheckoutTableAccessValuesForm
ОчередиОбработчиков=ProcessorQueue
ОчередьИСтатус=QueueStatus
ОчередьИСтатусОбработчика=QueueAndProcessorStatus
ОчередьОбластей=QueueAreas
ОчиститьДанныеНастроекИнтеграцииСУСП=ClearDataForSuspIntegrationSettings
ОчиститьДанныеОбъектаМетаданных=ClearMetadataObjectData
ОчиститьЗарегистрированныеПроблемыСДанными=ClearRegisteredProblemsWithData
ОчиститьОписаниеПрав=ClearDescriptionRights
ОчиститьПодсветку=ClearHighlight
ОчиститьПрогрессОбработкиЗаИнтервалыПредыдущегоДня=ClearProcessingProgressForPreviousDayIntervals
ОчиститьРезультатПоПроверке=ClearResultOnCheck
ОчиститьСтекНастроек=ClearStackSettings
ОчиститьУдаленныеСтандартныеРолиРасширений=ClearRemovedStandardExtensionRoles
ОчищатьДанные=ClearData
ОчищающийНабор=CleaningKit
ОшибкаВыгружаемыхДанных=DataUploadError
ОшибкаВызоваМетодаКомпоненты=ErrorCallMethodComponents
ОшибкаВыполненияЗапроса=RequestExecutionError
ОшибкаЗагрузкиНастроекХранилища=ErrorLoadingStorageSettings
ОшибкаКлиентНадпись=ErrorClientInscription
ОшибкаПриЗавершенииОбработчика=ErrorWhenCompletingHandler
ОшибкаПриСозданииМенеджераКриптографии=ErrorCreatingCryptoManager
ОшибкаСерверКартинка=ErrorServerImage
ОшибкаСерверНадпись=ErrorServerInscription
ОшибкаСертификатПомеченКакОтозванный=ErrorCertificateMarkedAsRevoked
ОшибкаСозданияМенеджераКриптографии=ErrorCreatingCryptographyManager
ОшибкиВыгружаемыхДанных=DataUploadErrors
ОшибкиЗагрузкиНастроекХранилища=ErrorsLoadingStorageSettings
ОшибкиПоВидамПроверок=ErrorsByTypesofChecks
ОшибкиПриАвтоматическомПродлении=ErrorsOnAutoRenewal
ОшибкиПриВыполненииОбработчиков=ErrorsWhenExecutingHandlers
ОшибкиСозданияМенеджераКриптографии=ErrorsCreatingCryptographyManager
ПакетАдминистрированиеРазрешений=PackageAdministrationOfPermissions
ПапкаГотовойВыгрузкиКонфигурацииВФайлыНачалоВыбора=FolderReadyToUploadConfigurationToFilesStartOfSelection
ПараметрВидПользователей=ParameterUserType
ПараметрВысотаШапки=ParameterHeightCaps
ПараметрИЗначение=ParameterFValue
ПараметрИспользуется=ParameterUsed
ПараметрКомпоновки=LayoutParameter
ПараметрОбновления=UpdateParameter
ПараметрПолученияПериодыДействия=ParameterForGettingValidityPeriods
ПараметрПолученияТолькоПлатные=ParameterForGettingPaidOnly
ПараметрПользователь=ParameterUser
ПараметрФорматИмени=ParameterFormatName
ПараметрФорматИмениВыбранный=ParameterFormatNameSelected
ПараметрФункции=ParameterFunctions
ПараметрыAuthJSON=AuthJSONParameters
ПараметрыАвторизацииУправляющегоПриложения=AuthorizationParametersForManagingApplication
ПараметрыВыполненияДочернихПотоков=ExecutionParametersChildThreads
ПараметрыВыполненияОбработки=ProcessingParameters_
ПараметрыДляЗаполненияОбъекта=ParametersForFillingObject
ПараметрыДляОчистки=ParametersToClear_
ПараметрыЗапросаАвторизации=ParametersAuthorizationRequest
ПараметрыЗапросаКоманднаяПанель=ParametersOfCommandPanelRequest
ПараметрыЗапросаЭтоВыражениеПриИзменении=RequestParametersAreExpressionWhenChanging
ПараметрыИзКодировкиURL=ParametersFromURLEncoding
ПараметрыИзСтрокиURI=ParametersFromStringURI
ПараметрыИндексаПоискаОтчетовКонфигурации=ParametersIndexSearchReportsConfiguration
ПараметрыКоманднаяПанель=OptionsCommandPanel
ПараметрыМногопоточнойОперации=MultithreadOperationParameters
ПараметрыМонитора=MonitorParameters
ПараметрыНастройкиСинхронизацииДанных=DataSynchronizationSettings_
ПараметрыНачальногоЗаполненияДанных1СПАРКРискиИндивидуальныхПредпринимателей=ParametersOfInitialDataFilling1SPARKRisksOfIndividualEntrepreneurs
ПараметрыНачальногоЗаполненияДанных1СПАРКРискиЮридическихЛиц=ParametersOfInitialDataFilling1SPARKRisksOfLegalEntities
ПараметрыОбновленияВСтроку=UpdateParametersToTheLine
ПараметрыОбновленияПакетногоЗапуска=BatchLaunchUpdateOptions
ПараметрыОплаты=PaymentParameters
ПараметрыОповещенияПриЗаписиСертификата=ParametersNotificationWhenWritingCertificate
ПараметрыОткрытияКоманднаяПанель=OpeningOptionsCommandPanel
ПараметрыОтображенияОтчетов=ReportDisplayOptions
ПараметрыОтчетовКонфигурации=ParametersReportsConfiguration
ПараметрыПереносаФайлов=FileTransferOptions
ПараметрыПодписиCAdEST=ParametersSignatureCAdEST
ПараметрыПодписиКриптографии=ParametersCryptoSignatures
ПараметрыПодсистемы=ParametersSubsystems
ПараметрыПолученияДополнительныхДанных=ParametersForObtainingAdditionalData
ПараметрыПотока=StreamParameters
ПараметрыПриЗапуске=StartupOptions
ПараметрыПримечание=ParametersNote
ПараметрыПроверкиВнедренияУправленияДоступом=AccessControlImplementationVerificationParameters
ПараметрыПродления=RenewalOptions
ПараметрыРасшифровкиОбъекта=ObjectDecryptionParameters
ПараметрыРасшифровкиРоли=ParametersDecryptionRoles
ПараметрыРедактированияЗначения=EditParametersValues
ПараметрыРедактированияУсловия=EditOptionsConditions
ПараметрыСозданияОбновления=UpdateCreationParameters
ПарольВХранилище=VaultPassword
ПарольДляВыгрузки=PasswordForUploading
ПарольПользователяУчетнойСистеимы=UserPasswordOfAccountingSystem
ПарольПользователяУчетнойСистеимыПриИзменении=UserPasswordOfAccountingSystemOnChange
ПарольПользователяУчетнойСистеимыПриИзмененииНаСервере=PasswordOfUserOfAccountingSystemWhenChangingOnServer
ПартнерыИКонтактныеЛицаКоманднаяПанель=PartnersAndContactPersonsCommandBar
ПартнерыИКонтактныеЛицаПриИзменении=PartnersAndContactPersonsOnChange
ПартнерыИКонтактныеЛицаСостояниеПросмотра=PartnersAndContactPersonsViewStatus
ПартнерыИКонтактныеЛицаСтрокаПоиска=PartnersAndContactPersonsSearchString
ПартнерыИКонтактныеЛицаУправлениеПоиском=PartnersAndContactPersonsSearchControl
ПервоеВзаимодействие=FirstInteraction
ПервоеПраво=FirstRight
ПервыеФизлица=FirstIndividuals
ПервыйДополнительныйЯзыкИзменен=FirstAdditionalLanguageChanged
ПервыйЗаголовокТаблицы=FirstTableHeader
ПервыйЗагружаемыйОбъектМетаданных=FirstMetadataObjectToLoad
ПеревестиТекстыТабличногоДокумента=TranslateSpreadsheetTexts
ПереданОтборПоДате=SubmittedSelectionByDate
ПередатьФайл=TransferFile_
ПередачаДанныхВСеврис=DataTransferToSevris
ПередачаЧастями=TransferInParts
ПередПолучениемДанныхМонитора=BeforeReceivingMonitorData
ПередФормированиемОтчета=BeforeFormationReport
ПерезаполнитьЛогинИПароль=RefillLoginPassword
ПерезаполнитьПароль=RefillPassword
ПерезапуститьМонопольноеОбновление=RestartExclusiveUpdate
Переименования=Renaming_
ПереименованияАбонент=RenamingSubscriber
ПереименованияДополнительныхСведений=RenamingAdditionalInformation
ПереименованияЗадачаПользователя=RenamingUserTask
ПереименованияКолонок=RenamingColumns
ПереименованияКонфигурации=RenamingConfiguration
ПереименованияОтветСозданияПодпискиНаТариф=RenamingAndCreatingSubscriptionToPricingPlan
ПереименованияПериоды=RenamingPeriods
ПереименованияПериодыДействия=RenamingValidityPeriods
ПереименованияПериодыОповещений=RenamingAlertPeriods
ПереименованияПодпискаНаТариф=RenamingSubscriptionPlan
ПереименованияПолейЗапроса=RenamingRequestFields
ПереименованияПользователиАбонента=RenamingSubscriberUsers
ПереименованияПриложение=RenamingApp
ПереименованияРасширения=RenamingExtensions
ПереименованияРезервныеКопийПриложения=RenamingApplicationBackups
ПереименованияРекомендуемыеТарифы=RenamingRecommendedRates
ПереименованияСвойств=RenamingProperties
ПереименованияСчет=RenamingAccount
ПереименованияСчетРезультатСозданияИзменения=RenamingAccountResultOfCreatingChange
ПереименованияСчетСостояние=RenamingAccountState
ПереименованияСчетТалонНаЗагрузку=RenamingInvoiceDownloadCoupon
ПереименованияСчетТарифы=RenamingInvoice
ПереименованияСчетУслуги=RenamingServiceAccount
ПереименованияСчетФайлы=RenamingAccountFiles
ПереименованияТариф=RenamingRates
ПереименованияТарифОбслуживающейОрганизации=RenamingServiceOrganizationRates
ПереименованияТарифОбслуживающейОрганизацииПериодыДействия=RenamingServiceOrganizationTariffValidityPeriods
ПереименованияТарифПериодыДействия=RenamesAndValidityPeriods
ПереименованияУслуги=RenamingService
ПереименованияУчетнаяСистема=RenamingAccountingSystem
ПереименованияУчетнаяСистемаПравилаВыгрузки=RenamingAccountingSystemUploadRules
ПереименованияУчетнаяСистемаПравилаЗагрузки=RenamingAccountSystemUploadRules
ПереименованияУчетнаяСистемаПравилаОбработкиОтветов=RenamingAccountSystemResponseProcessingRules
ПереименоватьСвойства=RenameProperties
ПерейтиВФормуМиграцииПриложения=GoToAppMigrationForm
ПерейтиКНастройкамПочты=GotoMailSettings
ПерейтиКНастройкамЭлектронногоДокументооборота=GoToElectronicDocumentManagementSettings
ПерейтиМеждуИзменениямиНастроек=JumpBetweenSettingsChanges
ПерейтиНаСледующийШаг=GoToNextStep
ПерейтиПоВнутреннейНавигационнойСсылке=FollowInternalNavigationLink
ПереключательДокументыНеОтправлятьПриИзменении=DoNotSendDocumentsRadioButtonOnChange
ПереключательДокументыОтправлятьАвтоматическиПриИзменении=SendDocumentsAutomaticallyRadioButtonsOnChange
ПереключательДокументыОтправлятьВручнуюПриИзменении=SendDocumentsManuallyRadioButtonsOnChange
ПереключательОтправлятьНСИАвтоматическиПриИзменении=SendMasterDataAutomaticallyRadioButtonsOnChange
ПереключательОтправлятьНСИНикогдаПриИзменении=NeverSendMasterDataRadioButtonsOnChange
ПереключательОтправлятьНСИПоНеобходимостиПриИзменении=SendMasterDataAsNecessaryRadioButtonsOnChange
ПереключательПоВсемОрганизациямПриИзменении=SwitchForAllOrganizationsWhenChanging
ПереключательПоВсемПодразделениямПриИзменении=SwitchForAllDivisionsWhenChanging
ПереключательПоВсемСкладамПриИзменении=SwitchForAllWarehousesWhenChanging
ПереключательПоВыбраннымОрганизациямПриИзменении=SwitchForSelectedOrganizationsWhenChanging
ПереключательПоВыбраннымПодразделениямПриИзменении=SwitchBySelectedDivisionsWhenChanging
ПереключательПоВыбраннымСкладамПриИзменении=SwitchBySelectedWarehousesWhenChanging
ПереключитьВидимостьКомандКолонтитулов=ToggleVisibilityCommandsFooters
ПереключитьВидимостьЭлемента=ToggleItemVisibility
Перенастроить=Readjust
ПеренестиЗадания=TransferTasks
ПеренестиНастройки=MoveSettings
ПереопределитьПараметрыПроверкиФоновыхЗаданийСПАРКРиски=RedefineTheParametersForCheckingBackgroundTasksSPARKRisks
ПереопределяемыеНастройки=OverriddenSettings
ПереформироватьОтчет=RebuildReport
ПереходДалее=GoNext
ПереходМеждуНастройкамиСтека=TransitionBetweenStackSettings
ПереходНаВерсиюИсторииДанных=TransitionToVersionHistoryData
ПереходНазад=GoBack_
ПереходНаУниверсальныйФормат=SwitchingToUniversalFormat
ПереходПоСсылкам=ClickOnLinks
ПереходПоСсылкеНаПортал=ClickOnTheLinkToThePortal
ПериодическаяОплата=PeriodicPayment
ПериодичностьОплаты=FrequencyOfPayment
ПериодНачалоДня=PeriodStartOfDay
ПериодРегистрацииГодОчистка=RegistrationPeriodYearCleaning
ПериодРегистрацииГодПриИзменении=RegistrationPeriodYearWhenModified
ПериодРегистрацииМесяцОчистка=RegistrationPeriodMonthCleaning
ПериодРегистрацииМесяцПриИзменении=RegistrationPeriodMonthForChanges
ПериодыОповещенийОбОкончанииПодписки=SubscriptionTerminationNotificationPeriods
ПечатнаяФормаСОшибкой=PrintedFormWithAnError
ПечатнаяФормаСчетаНаОплату=PrintedInvoiceForm
ПинКод=Pin
ПИФ=MutualFunds
ПланСчетов_ДемоОсновной=DemoMainChartOfAccounts
ПлатежнаяСсылка=PaymentLink_
ПлатежнаяСсылкаСчетаНаОплату=PaymentInvoiceLink
ПлатежныеРеквизиты=AttributesForPayment
ПоведениеГруппУзлаИерархииЭлементовФормыНастроекПереопределено=BehaviorGroupsNodeHierarchyElementsFormSettingsOverridden
ПоведениеПереопределено=BehaviorOverridden
ПоВидам=ByKinds
ПовторитьКодНажатие=RepeatCodeClick
ПовторитьПопыткуПередачиДанных=RetryDataTransfer
ПовторитьПопыткуСозданияПриложения=RetryAppCreation
ПодатьЗаявлениеНаСертификат=ApplyforCertificate
ПодверждениеСохраненияФайлаВыгрузкиЗавершение=ConfirmationOfSavingUploadFileCompletion
ПодготовитьМакетДляЗаписи=PrepareLayoutForRecording
ПодготовитьНастройкиОтчетаКРасшифровкеПоДетальнымЗаписям=PrepareReportSettingsToDecipherByDetailedRecords
ПодготовитьОтборОбработчикаРасшифровки=PrepareSelectionDecryptionHandler
ПодготовитьПрименяемыеНастройкиОбработчикаРасшифровки=PrepareAppliedHandlerSettingsDecryption
ПодготовитьРежимыПроверкиСертификата=PrepareCertificateVerificationModes
ПодготовитьСписокМетаданныхДляОбработки=PrepareListMetadataForProcessing
ПодготовитьСтруктуруРазделаОтчетаКРасшифровке=PrepareReportSectionStructureToDecipher
ПодготовитьСчетНаОплату=PrepareInvoiceForPayment
ПодготовитьФормуВопроса=PrepareQuestionForm
ПодготовкаЗаявления=PreparationOfApplication
ПодготовленныеСтандартныеРолиРасширенийСеанса=PreparedStandardRolesSessionExtensions
ПоддерживаетсяЗагрузкаТарифов=TariffLoadingIsSupported
ПоддерживаетсяРасчетРазмера=SupportedSizeCalculation
ПоддерживаетсяРасчетРазмераПриложений=ApplicationSizeCalculationIsSupported
ПоддержкаS3=S3Support
ПодключаемыеКомандыКонфигурации=PluginCommandsConfig
ПодключаемыеКомандыРасширений=ConnectableExtensionCommands
Подключаемый_ДоступныеПоляПередНачаломИзменения=Plugin_AvailableFieldsBeforeStartChanges
Подключаемый_ДоступныеПоляПриАктивизацииСтроки=PlugIn_AvailableFieldsWhenActivatingLine
Подключаемый_ДоступныеПоляПриОкончанииРедактирования=PlugIn_AvailableFieldsAtEndOfEditing
Подключаемый_ЗаполнитьДанныеПоКодуАктивации=PlugIn_FillInActivationCodeData
Подключаемый_ЗаполнитьФормуПослеАктивации=PlugIn_FillOutFormAfterActivation
Подключаемый_ЗаполнитьФормуПослеВхода=PlugIn_FillOutFormAfterLoggingIn
Подключаемый_ЗаполнитьФормуПослеРегистрации=PlugIn_FillOutFormAfterRegistration
Подключаемый_ИзменитьРазмерыФормы=PlugIn_ResizeForm
Подключаемый_Мультиязычность_ПроверитьВнедрение=Pluggable_Multilingualism_CheckImplementation
Подключаемый_НажатиеКнопки=PlugIn_PressingButton
Подключаемый_ОбразецПриИзменении=Pluggable_SampleWhenChanging
Подключаемый_ПерейтиМеждуИзменениямиНастроек=Plugin_GoBetweenSettingsChanges
Подключаемый_ПоказатьРезультатПроверкиАдресаЭлектроннойПочты=PlugIn_ShowResultOfEmailAddressVerification
Подключаемый_ПослеЗакрытияПередачи=PlugIn_AfterTransferIsClosed
Подключаемый_ПослеПередачиФайла=PlugIn_AfterFileTransfer
Подключаемый_ПослеПолученияАдресаЗагрузкиФайла=PlugIn_AfterReceivingFileUploadAddress
Подключаемый_ПослеСозданияПриложения=PlugIn_AfterAppCreation
Подключаемый_РазвернутьСтроки=Plugin_ExpandStrings
Подключение1СТакском=Connecting1CTaxi
ПодключенКХранилищу=ConnectedToStorage
Подключенные=ConnectedNow
ПодключитьИсточникДанныхПечатиЧислоПрописью=ConnectPrintDataSourceNumberWritten
ПодключитьОбработчикОбновленияСтатусаПереходаВСервис=EnableServiceStatusUpdateHandler
ПодключитьОбработчикОжиданияВыполненияРасчета=EnableCalculationWaitingHandler
ПодлежитУсовершенствованию=ToBeImproved
ПодобратьИмяОбласти=PickupRegionName
ПодобратьОбразец=PickupSample
ПодписанныйОбъектМетаданные=SignedObjectMetadata
ПодписатьсяНаОповещениеОбИзмененииОбъекта=SubscribeToNotificationsAboutObjectChanges
ПодписиИПечатиОбласти=SignaturePrintRegion
ПодпискаНаТариф=SubscriptionPlan
ПодпискиНаТарифы=SubscriptionsToPricingPlans
ПодразделенияКоманднаяПанель=DepartmentsCommandBar
ПодразделенияСостояниеПросмотра=DepartmentsViewStatus
ПодразделенияСтрокаПоиска=DepartmentsSearchString
ПодразделенияУправлениеПоиском=DepartmentsSearchControl
ПодробныеПраваОбъекта=DetailedObjectPermissions
ПодробныеПраваРолиНаОбъектМетаданных=DetailedPermissionsRolesOnMetadataObject
ПодсветитьЯчейкиСВыбраннымПолем=HighlightCellsWithSelectedField
ПодсистемаРаботаСФайлами=SubsystemWorkingWithFiles
ПодсказкаВводаСтрокиПоискаСпискаПолей=PromptInputStringSearchFieldList
ПодсказкаНаСервере=HintOnServer
ПодсказкаПрава=HintPermissions
ПодсказкаПроблемСДанными=TroubleHintWithData
ПодтверждениеЗагрузкиДругогоФайлаЗавершение=ConfirmingDownloadOfAnotherFileEnds
ПодтверждениеЗаменыИмени=NameReplacementConfirmation
ПодтвержденКод=CodeConfirmed_
ПодтвержденКодДляИнтеграцииСУСП=ConfirmedCodeForIntegrationOfSUSPS
ПодходящиеКоллекции=SuitableCollections
ПодчиненныеПоля=SubordinateFields
ПодчиненныеСправочникиКонфигурации=SubordinateDirectoriesConfiguration
ПозицияIDОригинальногоСообщения=PositionIDOriginalMessage
ПозицияВнутреннейНавигационнойСсылки=PositionOfInternalNavigationLink
ПозицияЗакрывающегосяТега=PositionClosingTag
ПозицияИЗ=PositionFrom_
ПозицияКонцаУсловия=ConditionEndPosition
ПозицияНавигационнойСсылки=NavigationLinkPosition
ПозицияОбщегоКаталога=SharedFolderPosition
ПозицияОткрывающегосяТега=PositionOpeningTag
ПозицияПоследнегоРазделителя=PositionOfLastSeparator
ПозицияПредпоследнегоРазделителя=PositionOfPenultimateSeparator
ПозицияПроцедуры=ProcedurePosition
ПозицияУсловногоВызова=ConditionalCallPosition
ПозицияФункции=FunctionPosition
ПоискИБ=InformationSecuritySearch
ПоискПоТипу=SearchByType
ПоискСервис=SearchService
ПоказатьДиалогПрерваннойЗагрузки=ShowAbortedDownloadDialog
ПоказатьДиалогПрерваннойЗагрузкиПередНачаломРаботыСистемы=ShowAbortedBootDialogBeforeStartingSystem
ПоказатьДиалогПрерваннойЗагрузкиПриНеобходимости=ShowAbortedDownloadDialogIfNecessary
ПоказатьОшибкуВыгрузкиДанных=ShowDataUploadError
ПоказатьОшибкуНаСтраницеОжидания=ShowErrorOnWaitingPage
ПоказатьПланВыполненияЗапросаНажатие=ShowTheRequestExecutionPlanByClicking
ПоказатьПраваПользователяНаТаблицы=ShowUserRightsOnTables
ПоказатьПредупреждениеПользователю=ShowAWarningToTheUser
ПоказатьПредупреждениеУстановленМонопольныйРежим=ShowWarningMonopolyModeIsSet
ПоказатьПризнакЗаполнения=ShowFillInFlag
ПоказатьСостояниеГотово=ShowStateReady
ПоказатьСостояниеОжидание=ShowWaitingState
ПоказатьСостояниеОшибка=ShowErrorState
ПоказатьСостояниеПусто=ShowStateEmpty
ПоказатьСпособИсправления=ShowCorrectionMethod
ПоказыватьВыполненныеЗаданияПриИзменении=ShowCompletedTasksWhenChanging
ПоказыватьОбъектыИРолиБезПрав=ShowObjectsAndRolesWithoutPermissions
ПоказыватьПланВыполненияЗапросаВВидеПриИзменении=ShowRequestExecutionPlanInWhenModifiedView
ПоказыватьПраваНаРеквизиты=ShowPermissionsOnDetails
ПоказыватьПраваНеинтерфейсныхПодсистем=ShowPermissionsofNonInterfaceSubsystems
покупателю=tobuyer
ПолеАдресОбработки=ProcessingAddressField
ПолеЕстьОграничение=FieldIsRestriction
ПолеИспользуемоеИмяФайла=UsedFileNameField
ПолеКонтактыПровайдера=ProviderContactsField
ПолеЛогин=LoginField
ПолеПериодыДействия=ValidityPeriodsField
ПолеРоль=RoleField
ПолеСсылкаДобавлено=FieldReferenceAdded
ПолеСтрокой=Field_String
ПолеТариф=TariffField
ПолеУдаленноеИзСхемы=FieldRemovedFromTheSchema
ПолеХранения=StorageField
ПолноеИмяCFUФайлаВКаталогеДистрибутивов=FullNameOfCFUFileInDistributionDirectory
ПолноеИмяЗагружаемогоОбъектаМетаданных=FullNameOfMetadataObjectToLoad
ПолноеИмяПервогоЗагружаемогоОбъектаМетаданных=FullNameOfFirstMetadataObjectToLoad
ПолноеИмяСобытия=FullNameOfEvent
ПолноеИмяФайлаВложения=FullNameOfAttachmentFile
ПолноеИмяФайлаДанных=FullDataFileName
ПолноеИмяФормыВыбора=FullChoiceFormName
ПолныеИменаОбъектовМетаданныхВключаяУдаленные=FullNamesofMetadataObjectsIncludingRemote
ПолныеИменаРолей=FullRoleNames
ПолныеИменаТиповИсключаемыхИзВыгрузкиЗагрузки=FullNamesOfTypesExcludedFromUploadUpload
ПолныеИменаУдаленныхИОтключенныхРолей=FullNamesofRemovedDisabledRoles
ПолныйАрхив=FullArchive
ПолныйНомерТелефонаТолькоЦифры=FullPhoneNumberOnlyDigits
ПолныйПутьКФормеПередЗаписьюПередЗаписью=FullFormPathBeforeWriteBeforeWrite
ПолныйРазмер=FullSize
ПолучатьПланВыполненияЗапросаПриИзменении=GetRequestExecutionPlanWhenChangesAreMade
ПолучениеГраницы=GettingBorder
ПолучениеСвойств=Get_Properties
ПолученоОповещениеОбИзмененииОбъекта=ReceivedNotificationAboutObjectChanges
ПолученоСогласие=ConsentObtained
ПолучитьDT=GetDT
ПолучитьS3=GetS3
ПолучитьАдресОшибокВоВременномХранилище=GetAddressofErrorsInTemporaryStorage
ПолучитьДанныеОблачнойПодписи=GetDataCloudSignature
ПолучитьДанныеПоВзаимодействию=GetInteractionData
ПолучитьДанныеПоОбращению=GETRequestData
ПолучитьДанныеПоПереписке=GetDataOnCorrespondence
ПолучитьДанныеСертификатов=GetCertificateData_
ПолучитьДеталиОшибки=GetErrorDetails
ПолучитьДоступКФайлу=AccessFile
ПолучитьИмяИРасширениеФайла=GetFileNameAndExtension
ПолучитьИмяФайлаИАдресХранилищаФайла=GetFileNameAndFileStorageAddress
ПолучитьИндексЭлементаФормы=GetIndexOfFormElement
ПолучитьИнформациюОВозможностяхПерехода=GetInformationAboutTransitionOptions
ПолучитьКлючДоступаУстройства=GetDeviceAccessKey
ПолучитьКлючиДоступаВебКлиент=GetAccessKeysWebClient
ПолучитьКлючиДоступаКПочтовомуСерверу=GetAccessKeysToMailServer
ПолучитьКонтейнерПодписейКриптографии=GetCryptographySignatureContainer
ПолучитьОбработкуССервера=GetProcessingFromServer
ПолучитьПараметрыАвторизацииВВебКлиенте=GetAuthorizationParametersInWebClient
ПолучитьПараметрыДоступа=GetAccessParameters
ПолучитьПредставлениеСпискаОбращений=GetPresentationOfListOfRequests
ПолучитьПроксиСлужбыПоддержки=GetSupportProxy
ПолучитьРазмерФайла=GetFileSize
ПолучитьРазмерФайлаИзЛогическогоХранилища=GetFileSizeFromLogicalStorage
ПолучитьРазмерФайлаИзХранилищаМенеджераСервиса=GetFileSizeFromServiceManagerStorage
ПолучитьРесурсФормы=GetFormResource
ПолучитьСвойстваПодписи=GetSignatureProperties
ПолучитьСвойстваПодписиПослеПодписания=GetSignaturePropertiesAfterSigning
ПолучитьСвойствоПодписиCAdES=GetCAdESSignatureProperty
ПолучитьСервераШтамповВремени=GetServerStampsTime
ПолучитьСинонимыПодсистем=GetSynonymsForSubsystems
ПолучитьСохраненныйОтветПользователя=GetSavedUserResponse
ПолучитьУпорядоченныйСписокФайловДанных=GetOrderedListDataFiles
ПользователиПользователь=UsersUser
ПользователиСертификатаСтрокой=UsersCertificateString
Пользователь_=User_
ПользовательИзКеша=UserFromCache
ПользовательНастройки=User_Settings
ПользовательОповещен=UserAlerted
ПользовательОповещенОСертификате=UserAlertedOnCertificate
ПользовательПриложения=ApplicationUser
ПользовательСеанса=SessionUser
Пользовательская=Custom_2
ПользовательскаяНастройкаПараметра=CustomParameterSetting
ПользовательскиеНастройкиЗаполненияЭлементов=CustomSettingsFillItems
ПоляКонтактнойИнформации=ContactInformationFields
ПоляМакета=FieldsLayout
ПоляСхемы=SchemaFields
ПоляСхемыКомпоновкиДанных=DataCompositionSchemaFields
ПоляТелефона=Phonefields
ПоместитьВоВременноеХранилищеДвоичныеДанныеСхемы=PlaceBinarySchemaDataInTemporaryStorage
ПоместитьФайлВСчет=PlaceFileInInvoice
ПоместитьФайлСРасширениемОповещение=PlaceFileWithAlertExtension
ПоместитьФайлСРасширениемОповещениеРазмерОповещение=PlaceFileWithExtensionAlertSizeAlert
ПоместитьФайлыБезРасширения=PlaceFilesWithoutExtension
ПоместитьФайлыБезРасширенияНаСервере=PlaceFilesWithoutExtensionOnServer
ПоместитьФайлыСРасширением=PlaceFilesWithExtension
ПометитьНаУдалениеУстаревшиеПоставляемыеДанные=MarkForDeletionObsoleteSuppliedData
ПометкаУдаленияСОтображением=MarkingDeletionsWithDisplay
ПомещениеФайлов=PlacingFiles
ПоРолиИсполнителяПриИзменении=ByRoleOfPerformerWhenChange
ПоручениеИсполнителюПриВыполнении=AssignmentToTheExecutorWhenExecuting
Порции=Portions
ПорцияОбработана=PortionProcessed
ПорядкиНеРавны=OrdersAreNotEqual
ПорядокКоманды=CommandOrder
ПорядокКомандыТекущихНастроекСтека=OrderCommandCurrentStackSettings
ПорядокПрава=OrderRight
ПорядокПрава2=OrderRights2
ПорядокТипаОбъекта=ObjectTypeOrder
ПослеВопросаОбОтключенииСинхронизации=AftertheQuestionAboutDisablingSynchronization
ПослеВыбораОбработчиков=AfterSelectHandlers
ПослеВыбораОбъектовМетаданных=AfterSelectingMetadataObjects
ПослеВыполнения=AfterExecution
ПослеВыполненияОтправкиПредупрежденийПользователям=AfterPerformingSendingAlertsToUsers
ПоследниеИдентификаторыРолей=LatestRoleIds
ПоследняяЧасть=LastPart
ПослеЗавершенияЗаменыСсылок=AfterCompletionReplacingLinks
ПослеЗавершенияОпределенияМестИспользования=AfterCompleteDeterminingUseLocations
ПослеЗавершенияСеансов=AfterCompletingSessions
ПослеЗагрузкиДанныхИнформационнойБазы=AfterLoadingDatabaseData
ПослеЗагрузкиНастроекВКомпоновщик=AfterLoadSettingsInLinker
ПослеЗапускаПриложенияФайла=AfterLaunchingFileApplication
ПослеОтветаНаВопросСертификатОтозван=AfterAnsweringQuestionCertificateRevoked
ПослеПомещенияФайлаОбработкиНаСервер=AfterPlacingProcessingFileOnServer
ПослеПомещенияФайлов=AfterPutFiles
ПослеПредупреждения=AfterWarning
ПослеПроверкиРежимаВыгрузкиДляТехническойПоддержки=AfterCheckingUnloadingModeForTechnicalSupport
ПослеУдаленияФайлаПриПрерывании=AfterDeletingFileOnInterrupt
ПослеУсовершенствованияПодписи=AfterImprovementSignature
ПослеУстановкиДанныхАвторизации=AfterSettingAuthorizationData
ПоставитьНаМониторинг=PutOnMonitoring
ПоставляемыеДанныеХарактеристикиДанных=SuppliedDataDataCharacteristics
ПоставляемыеПрофилиСеанса=SuppliedSessionProfiles
ПоставляемыйЭлемент=SuppliedItem
ПостроительСхем=CircuitBuilder
ПотокДляЧтения=ReadStream
ПотокиДлительныхОпераций=ThreadsLongOperations
ПотокиПроцесса=ThreadsProcess
ПотокЧтенияДанныхАрхива=ArchiveDataReadingStream
ПочтаПокупателя=BuyerSMail
ПочтаПродавца=SellerSMail
ПочтаСсылка=MailLink
ПочтовыйДомен=MailDomain
ПояснениеКЕстьОтвет=ExplanationKIsAnswer
ПоясненияПоОшибке=ExplanationOnError
ПраваБизнесПроцесса=RightsBusinessProcess
ПраваВнешнегоИсточникаДанных=RightsExternalDataSource
ПраваДокумента=DocumentPermissions
ПраваЖурналаДокументов=PermissionsJournalDocuments
ПраваЗадачи=RightsTasks
ПраваКонстанты=RightsConsts
ПраваКонфигурации=ConfigRights
ПраваКубаИТаблицыИзмерений=PermissionsCubeAndDimensionTables
ПраваНаОтсутствующиеДанные=RightsOnMissingData
ПраваНаРеквизиты=RightsOnDetails
ПраваОтчетаОбработкиФункции=RightsReportProcessingFunctions
ПраваПараметраСеанса=SessionSettingRights
ПраваПланаОбмена=ExchangePlanRights
ПраваПользователейКоманднаяПанель=UsersRightsCommandBar
ПраваПользователейМиграции=MigrationUserRights
ПраваПользователейПраво=UsersRightsRight
ПраваПоследовательностиИПерерасчета=SequenceAndRecalculationRights
ПраваПоУмолчанию=PermissionsDefault
ПраваРегистраНакопленияИБухгалтерии=RightsRegisterAccumulationAndAccounting
ПраваРегистраРасчета=RightsRegisterCalculation
ПраваРегистраСведений=RightsRegisterInformation
ПраваРеквизита=RightsAttributes
ПраваРолейНаОбъект=RightsRolesOnObject
ПраваРолейНаОбъектМетаданных=RightsRolesOnMetadataObject
ПраваРолиНаОбъектыМетаданных=RightsRolesOnMetadataObjects
ПраваСправочникаИПланов=RightsofDirectoryandPlans
ПраваТаблицыВнешнегоИсточникаДанных=RightsTableExternalDataSource
ПраваУровней=RightsLevels
ПравилаВыгрузки=UploadRules
ПравилаЗагрузки=LoadingRules
ПравилаОбработкиОтветов=ResponseProcessingRules
ПравилаРегистрацииВМенеджере=RulesForRegisteringInManager
ПравильныйРазмер=CorrectSize
ПравоБезОграничения=RightUnlimited
ПравоДоступаДобавление=AccessRightInsert
ПравоИнтерактивноеДобавлениеРасшифровка=RightInteractiveAddingDecipher
ПравоИспользование=RightUse
ПравоПросмотрРасшифровка=RightViewDecoding
ПравоРедактированиеРасшифровка=RightEditingTranscript
ПравоСОграничением=RightWithRestriction
ПравыйРазряд=RightDischarge
ПредлагатьБольшеНеПредупреждать=SuggestMoreDontWarn
ПредставлениеАдресаДоставкиНачалоВыбора=PresentationOfDeliveryAddressBeginningOfSelection
ПредставлениеАдресаДоставкиОбработкаВыбора=DeliveryAddressRepresentationSelectionProcessing
ПредставлениеАдресаДоставкиОчистка=PresentationOfTheDeliveryAddressCleaning
ПредставлениеАдресаДоставкиПриИзменении=RepresentationOfDeliveryAddressWhenChanging
ПредставлениеГруппыВнешнихПользователей=ExternalUserGroupView
ПредставлениеГруппыПользователей=ViewUserGroup
ПредставлениеДебет=DebitSubmission
ПредставлениеДействияСтекаНастроек=ViewActionStackSettings
ПредставлениеКредит=SubmissionCredit
ПредставлениеНеизвестногоВидаДоступа=RepresentationUnknownAccessType
ПредставлениеНеопределено=ViewUndefined
ПредставлениеОбласти=ViewArea
ПредставлениеПериодаОтчета=ReportPeriodView
ПредставлениеПерсонально=ViewPersonal
ПредставлениеПраваПользователя=PresentationOfUserRights
ПредставлениеРежимаЗапуска=PresentationRunMode
ПредставлениеСпискаОбращений=PresentationOfListOfRequests
ПредставлениеСтатусаПроверки=ViewStatusChecks
ПредставлениеСубконто=RepresentationOfSubconto
ПредставлениеСчет=AccountSubmission
ПредставлениеФормулыПоДаннымФормы=ViewFormulaByFormData
ПредставлениеЭлектроннойПочтыПриИзменении=EmailSubmissionWhenModified
ПредставлениеЭлементаОтбора=SelectionItemView
ПредставлениеЯзык1=DisplayLanguage1
ПредставлениеЯзык2=DisplayLanguage2
ПредставленияВидовСравнения=RepresentationsViewsComparisons
ПредставленияПараметровТекста=RepresentationTextParameters
ПредставленияТиповЗначенийДополнительныхСведений=PresentationsOfValueTypesForAdditionalInformation
ПредставленияЯзыка1=CaptionLanguage1
ПредставленияЯзыка2=CaptionLanguage2
Предупредить=Warn
ПредупреждатьОЗацикливании=WarnLooping
ПредупреждениеОбАктивныхРасширенияхИзменяющихСтруктуруДанныхЗавершение=WarningAboutActiveExtensionsThatChangeDataStructureCompletion
ПредупреждениеОбОшибке=ErrorWarning
ПредупреждениеПослеПроверкиУЦ=WarningAfterCheckingUC
ПредупреждениеПриПроверкеУдостоверяющегоЦентраСертификата=WarningWhileVerifyingCertificateAuthorityCertificate
ПредупрежденияКоманднаяПанель=WarningsCommandPanel
ПредыдущаяОшибка=PreviousError
ПредыдущаяТаблица=PreviousTable
ПредыдущийРазмер=PreviousSize
ПредыдущийСимволЭтоРазделитель=PreviousCharacterThisDelimiter
ПреобразованиеДанныхJSON=ConvertingJSONData
ПреобразованиеДатыДляHTTP=ConvertDateForHTTP
ПреобразоватьКартинкиВBase64=ConvertPicturesToBase64
ПреобразоватьПодписиВМассив=ConvertSignaturestoArray
ПрерватьВыполнение=AbortExecution
ПрерватьВыполнениеЕслиОшибка=AbortExecutionIfError
ПрерватьЗаписьПриНаличииОшибокВМакете=AbortRecordingIfThereAreErrorsInLayout
ПрерватьСканированиеРезультатаОтчета=AbortScanReportResult
ПрерыватьОбработкуМассиваПриОшибке=AbortArrayProcessingOnError
Префикс=Prefix
ПрефиксИмениКомандыПереходаМеждуИзменениямиНастроек=PrefixCommandNameTransitionBetweenSettingChanges
ПриведенноеЗначениеДаты=GivenDateValue
ПриВыбореИмениМакета=OnSelectingLayoutName
ПриВыбореФорматаПоля=WhenFormatFieldSelection
ПриВыполненииОбработчикаОжиданияВФормеМонитора=WhenExecutingAWaitHandlerInTheFormOfAMonitor
ПриглашениеДляРегистрацииНеДоступно=NoRegistrationInvitationIsAvailable
ПриДобавленииОписанийСервисовСопровождения=WhenAddingSupportServiceDescriptions
ПриЗавершенииЗагрузкиТарифов=WhenLoadingTariffsIsComplete
ПриЗавершенииРедактированияФормулы=WhenFinishedEditingFormulas
ПриЗагрузкеТарифов=WhenLoadingTariffs
ПриЗакрытииФормыМонитора=WhenClosingTheMonitorForm
ПриЗаписиНастроекИнтеграции=WhenRecordingIntegrationSettings
ПриЗаполненииПриоритетовТиповМетаданных=WhenPrioritizingMetadataTypes
ПризнакБлокировки=SignLock
ПризнакОригиналПолучен=SignOriginalReceived
ПриИзмененииВариантаРегистрации=WhenChangingRegistrationOption
ПриИзмененииОбразца=WhenChangingSample
ПриИзмененииОбразцаНаСервере=WhenChangingSampleOnServer
ПриИзмененииОпцииАвтономногоРежимаРаботы=WhenChangingOfflineModeOption
ПриИзмененииРеквизита=WhenChangingTheDetails
ПриИзмененииСпособаПерехода=WhenChangingTransitionMethod
ПрикрепитьФайлОповещение=AttachAlertFile
ПрименитьНастройкиИПереформироватьОтчет=ApplySettingsAndReshapeReport
ПрименятьФорматирование=ApplyFormatting
ПримерыЗначений=ExampleValues
ПриНажатииДекорацииВФормеМонитора=WhenYouClickTheSceneryInTheFormOfAMonitor
ПриНачалеВыбораЗначений=AtStartValueSelection
ПриНачалеВыбораЗначенийОтчетаАнализПравДоступа=AttheStartofSelectingReportValuesAnalysisAccessPermissions
ПриНачалеВыбораЗначенийОтчетаПраваРолей=AttheStartofSelectingReportValuesRoleRights
ПриНачальномЗаполненииВидовКонтактнойИнформации=AttheInitialFillingoftheTypesofContactInformation
ПринятыеДанныеКоллизии=AcceptedCollisionData
ПриОбработкеРасшифровкиОтчетаАнализПравДоступа=WhenProcessingReportDecryptionAccessPermissionAnalysis
ПриОбработкеРасшифровкиОтчетаПраваРолей=WhenProcessingDecodingReportRightsRoles
ПриОпределенииДанныхБанковскогоСчетаSWiP=WhenDeterminingTheBankAccountDataSWiP
ПриОпределенииДанныхОрганизацииSWiP=WhenDeterminingTheCompanySDataSWiP
ПриОпределенииДоступностиРегистрацииSWiP=WhenDeterminingTheAvailabilityOfRegistrationSWiP
ПриОпределенииДоступныхДляПереводаМакетов=WhenDefiningAvailableForTranslationLayouts
ПриОпределенииИсточниковДанныхПечати=WhenDefiningPrintDataSources
ПриОпределенииИсточниковДоступныхПолей=WhenDefiningAvailableFieldSources
ПриОпределенииНастроекИнтеграции=WhenDefiningIntegrationSettings
ПриОпределенииНомераВерсииПрограммы=WhenDeterminingTheVersionNumberOfTheProgram
ПриОпределенииОбщихПараметровМонитора=WhenDeterminingTheGeneralParametersOfTheMonitor
ПриОпределенииПоддержкиЗагрузкиТарифов=WhenDeterminingTariffLoadingSupport
ПриОпределенииСвойствСправочниковКонтрагентов=WhenDeterminingThePropertiesOfCounterpartyDirectories
ПриоритетыОбновления1=UpdatePriorities1
ПриоритетыОбновления2=UpdatePriorities2
ПриоритетыОбновленияТипов=TypeUpdatePriorities
ПриоритетыТиповМетаданных=PrioritizingMetadataTypes
ПриОткрытииФормыНастроекИнтеграции=WhenOpeningTheIntegrationSettingsForm
ПриПервомСерверномВызове=OnFirstServerCall
ПриПереходеДалее=OnTransitionNext
ПриПереходеНазад=OnGoingBack
ПриПодготовкеДанныхПечати=WhenPreparingPrintData
ПриПодтвержденииОтключенияСвязиСГлавнымУзлом=WhenConfirmingDisconnectionOfCommunicationWithTheMasterNode
ПриПолученииДанныхСчетаНаОплату=WhenReceivingInvoiceDataForPayment
ПриПолученииДополнительныхДанныхМонитора=WhenReceivingAdditionalMonitorData
ПриПолученииОтветаПочтовогоСервера=OnReceiveMailServerResponse
ПриПолученииПечатнойФормыСчетаНаОплату=UponReceiptOfPrintedInvoiceForm
ПриПолученииПлатежнойСсылки=WhenReceivingPaymentLink
ПрисоединенныеФайлыКОбъекту=AttachedFilesToObject
ПриСозданииНаСервереСПАРК=WhenCreatingOnTheSPARKServer
ПриСозданииПредопределенныхНаборовСвойств=WhenCreatingPredefinedPropertySets
ПриСозданииСчетаНаОплату=WhenCreatingInvoice
ПриСозданииФормыМонитора=WhenCreatingAMonitorForm
ПрисутствуетОбъектМетаданныхВСписке=MetadataObjectInList
ПриУспешномВводеКодаРегистрации=WhenRegistrationCodeIsSuccessfullyEntered
ПриУспешномНачалеВыполненияРегламентногоЗадания=UponSuccessfulStartoftheExecutionoftheScheduledTask
ПриФормированииЗаказаНаВозвратSWiP=WhenFormingARefundOrderSWiP
ПриФормированииЗаказаНаВозвратСБП=WhenFormingAnOrderForTheReturnOfTheSBP
ПриФормированииЗаказаНаОплатуSWiP=WhenFormingAnOrderForPaymentSWiP
ПриФормированииЗаказаНаОплатуСБП=WhenFormingAnOrderForPaymentOfSBP
ПриФормированииНадежностьДебиторов=WhenFormingTheReliabilityOfDebtors
ПриФормированииОтчетаНадежностьВходящегоНДС=WhenGeneratingTheIncomingVATReliabilityReport
ПроблемаВДанных=ProblemInData
ПроблемаНеПерваяОчередь=ProblemIsNotFirst
ПроблемныеСитуацииВОбработчикахОбновления=ProblemSituationsInUpdateHandlers
ПроблемыПоОбработчику=ProblemsByHandler
ПроблемыСДаннымиВОбработчиках=ProblemswithDatainHandlers
ПроброситьПрогрессВУправляющийПоток=ThrowProgressInControlThread
ПроверенныеВозможныеПраваСеанса=CheckedPossibleSessionPermissions
ПроверенныеПоставляемыеПрофилиСеанса=VerifiedSuppliedSessionProfiles
ПроверенныеСвойстваВидовДоступаСеанса=CheckedSessionAccessViewProperties
ПроверитьАдресПочты=CheckEmailAddress
ПроверитьАдресСервиса=CheckServiceAddress
ПроверитьАктуальностьНовыхРолейПользователейВСеансе=CheckActualityofNewUserRolesInSession
ПроверитьБлокировку=CheckLock
ПроверитьВводПароля=CheckPasswordEntry
ПроверитьВключатьРасширениеКонфигурацииДляПлановОбменаВМоделиСервиса=CheckToIncludeConfigurationExtensionForExchangePlansInServiceModel
ПроверитьВозможностьАвтоматическогоПереходаСРасширениями=CheckIfYouCanAutomaticallyNavigateWithExtensions
ПроверитьВСервисеВместоПроверкиНаСервере=ValidateInServiceInsteadofValidateOnServer
ПроверитьВСервисеПослеОшибки=CheckInServiceAfterError
ПроверитьВыгрузкаВАрхивеСовместимаСТекущейВерсиейКонфигурации=CheckIfUploadingToArchiveIsCompatibleWithCurVersionOfConfiguration
ПроверитьВыгрузкаВАрхивеСовместимаСТекущейКонфигурацией=CheckIfUploadingToArchiveIsCompatibleWithCurConfiguration
ПроверитьВыполнениеОтложенногоОбновления=CheckPerformDeferredUpdate
ПроверитьВыполнениеПроверкаУсловия=CheckTheFulfillmentOfTheConditionCheck
ПроверитьДанныеАутентификации=VerifyAuthenticationData
ПроверитьЗаполнениеДанныхВнешнихКомпонент=CheckTheDataFillingOfExternalComponents
ПроверитьЗаполнениеНаСтраницеНастройкиАвторизацииПриложения=CheckFillingOnPageSettingsAuthorizationApplication
ПроверитьЗаполнениеРеквизита=CheckTheFillingOfTheBankingDetails
ПроверитьКодАктивации=CheckActivationCode
ПроверитьКодПользователя=CheckUserCode
ПроверитьКодПользователяДляУСП=CheckUserCodeForUSP
ПроверитьПоддержкуРасчетаРазмераПриложений=CheckSupportForAppSizeCalculation
ПроверитьПодписьНаКлиентеПослеОшибкиПолученияКонтейнераПодписиНаКлиенте=CheckSignatureOnClientAfterErrorReceivingContainerSignatureOnClient
ПроверитьПодписьНаКлиентеПослеПолученияКонтейнераПодписи=CheckSignatureOnClientAfterReceiptContainerSignature
ПроверитьПолучениеДанных=CheckDataReceipt
ПроверитьПолучениеДанныхНаСервере=CheckDataReceptionOnServer
ПроверитьПриСозданииВложенныхБизнесПроцессов=CheckWhenCreatingNestedBusinessProcesses
ПроверитьРезультатЗаданияРасчетаРазмераПриложения=CheckResultOfApplicationSizeCalculationTask
ПроверитьРезультатЗапроса=CheckQueryResult
ПроверитьРезультатЗапросаНаСервере=CheckQueryResultOnServer
ПроверитьСертификатПослеПроверкиНаКлиентеИСервере=VerifyCertificateAfterVerificationOnClientServer
ПроверитьСертификатСПараметрамиПослеПолученияРезультата=VerifyCertificateWithParametersAfterReceivingResult
ПроверитьЦелостностьПодсистем=CheckTheIntegrityOfSubsystems
ПроверитьЦелостностьПодсистемыРаботаСФайлами=CheckTheIntegrityOfTheSubsystemWorkingWithFiles
ПроверитьЧтоСледующийСимволИмениПеременной=CheckWhatNextCharacterVariableName
ПроверкаАдресаЭлектроннойПочты=EmailAddressVerification
ПроверкаВСервисе=CheckInService
ПроверкаВСервисеВместоПроверкиНаСервере=ValidationInServiceInsteadofValidationOnServer
ПроверкаНаВсеПустыеПометки=CheckingForAllEmptyMarks
ПроверкаНаКлиентеСертификатаСервиса=ServiceCertificateCheckOnClient
ПроверкаРегистра=CheckingRegister
ПроверкаРежимаВыгрузкиДляТехническойПоддержки=CheckingUnloadingModeForTechnicalSupport
ПроверкаРежимаВыгрузкиДляТехническойПоддержкиЗавершение=CheckingUnloadingModeForTechnicalSupportCompletion
проверке=Verification
ПроверкиКоманднаяПанель=ChecksCommandPanel
ПроверкиСостояниеПросмотра=CheckingTheViewingStatus
ПроверкиСтрокаПоиска=ChecksTheSearchBar
ПроверкиУправлениеПоиском=ChecksSearchManagement
ПроверяемыеБизнесПроцессы=VerifiableBusinessProcesses
ПроверяемыеКонстанты=CheckedConstants
ПроверяемыеПредметыЗаданий=TestableTaskItems
ПроверяемыеФайлы=CheckedFiles
ПроверяемыйИнтервал=CheckedInterval
ПроверятьВерсиюКонфигурации=CheckConfigurationVersion
ПроверятьДублированиеЗаписей=CheckForDuplicateRecords
ПроверятьНеобходимостьВыполнения=CheckRequiredExecution
ПроверятьПравоЧтения=CheckTheRightToRead
ПрогрессМногопоточногоПроцесса=ProgressofMultithreadedProcess
ПрогрессОбработки=ProgressProcessing
ПрогрессОбработкиДанных=DataProcessingProgress
ПрогрессОтложенногоОбновленияЗависимости=ProgressDelayUpdateDependencies
ПрогрессОтложенногоОбновленияОшибки=ProgressDeferredUpdateErrors
Продление=Extension_
ПродлениеСрокаДействияПодписи=ExtensionValiditySignature
ПродлитьДействиеПодписей=ExtendActionSignatures
Продолжить=Continue
ПродолжитьЗагрузкуИзФайла=ContinueDownloadFromFile
ПродолжитьЗаписьТабличногоДокумента=ContinueWritingTabularDocument
ПродолжитьПослеУсовершенствованияНаСервере=ContinueAfterImprovementsOnServer
ПродолжитьПроцедуруЗагрузки=ContinueLoadingProcedure
ПродолжитьСохранениеВФайл=ContinueSavingToFile
ПродолжитьУсовершенствованиеПослеОтветаНаВопрос=ContinueImproveAfterAnsweringQuestion
ПроизводственныеКалендариКоманднаяПанель=ProductionCalendarsCommandPanel
ПройденаТекущаяНастройкаСтека=PassedCurrentStackSetting
ПропуститьОбновление=SkipNowUpdate
ПропуститьОтменуТранзакций=SkipCancelingTransactions
ПросмотреноВзаимодействиеПоОбращению=ViewedInteractionOnRequest
ПросмотрЗашифрованных=ViewEncrypted
ПросмотрИсторииДанных=ViewHistoryData
ПространствоИменРасширения=NamespaceExtensions
ПространствоИменРасширенияФормата=NamespaceFormatExtensions
профилей=Profiles
ПрофилиВместоРолей=ProfilesInsteadofRoles
ПрофилиРолей=RoleProfiles
ПрофилиРоли=IsProfilesRoles
ПроцедураПроверкиОкончаниеВводаТекстаПослеВопроса=ProcedureChecksFinishingTextInputAfterQuestion
процедуре=Procedure
ПрочиеОтношенияПриИзменении=OtherRelationshipsWhenChanging
ПрочитанныйПрогресс=ReadProgressNow
ПрочитатьАрхивВнутр=ReadArchiveInside
ПрочитатьВложенныйНесжатыйАрхив=ReadAttachedUncompressedArchive
ПрочитатьВФайлИзТома=ReadToFileFromVolume
ПрочитатьДанныеВосстанавливаемыхРасширенийОбласти=ReadDataOfRecoverableAreaExtensions
ПрочитатьЗаписиКаталога=ReadDirectoryEntries
ПрочитатьЗаписьКаталога=ReadDirectoryEntry
ПрочитатьКодПользователя=ReadUserCode
ПрочитатьКонецКаталога=ReadEndOfDirectory
ПрочитатьКонецКаталога64=ReadEndOfDirectory64
ПрочитатьЛокатор64=ReadLocator64
ПрочитатьМакет=ReadLayout
ПрочитатьОперандыИзФормулы=ReadOperandsFromFormula
ПрочитатьОтметкуОНапоминании=ReadNoteReminder
ПрочитатьСКомпьютераКодПользователяДляУСП=ReadUserCodeFromComputerForUSP
ПрочитатьТекстВПолеКолонтитула=ReadTextInFooterField
ПсевдонимАдресаПеренаправления=AliasRedirectAddresses
ПсевдонимИдентификатораПриложения=ApplicationIDAlias
ПсевдонимПароляПриложения=ApplicationPasswordAlias
ПубличныйИдентификаторПокупателя=PublicBuyerID
ПунктНачалоВыбора=PointStartChoice
ПунктПриИзменении=PointOnChange
ПустойПрофиль=EmptyProfile
ПустойРодитель=EmptyParent
ПустыеСсылкиЗначенийДоступа=EmptyAccessValueReferences
ПутьКВнешнейКонсолиЗапросовНачалоВыбора=PathToExternalQueryConsoleStartOfSelection
ПутьКДаннымВладельцаИсточника=SourceOwnerDataPath
ПутьКДаннымВоВложеннойСхеме=DataPathInNestedSchema
ПутьКДаннымРисунков=PathToPathPathPictures
ПутьКФайлуМодуляКоманды=PathToCommandModuleFile
ПутьКФайлуМодуляОбъекта=PathToObjectModuleFile
ПутьКФайлуОбщегоМодуля=PathToSharedModuleFile
ПутьКФайлуПредыдущейВерсииКонфигурацииНачалоВыбора=PathToFileOfPreviousVersionOfConfigurationIsBeginningOfSelection
ПутьНаКлиентеНачалоВыбора=PathOnClientIsBeginningOfSelection
ПутьНаСервереS3=PathOnS3Server
ПутьФайлаИсточник=FilePathSource
ПутьФайлаПриемник=FilePathDestination
РаботаСПапкамиФайлов=WorkingWithFileFolders
РаботаСРекламойКлиент=WorkingWithAdsClient
РазблокированныеОбъекты=UnlockedObjects
РазблокироватьОбъектДляРедактирования=UnlockObjectToEdit
РазблокироватьОбъектДляРедактированияПослеВопроса=UnlockObjectToEditAfterQuestion
РазделАвторизация=AuthorizationSection
РазделенноеЧисло=SplitNumber
Разделенные=Separated_Data
РазделенныйКод=SplitCode
РазделительДробнойЧасти=FractionalPartSeparator
РазделитьКодПользователя=SplitUserCode
РазделитьНаОбласти=DivideInRegions
РазделитьЧисло=DivideNumber
РазделОсновное=MainSection_
РазделыНаУдаление=Sections_ToDelete
РазличныеМодули=DifferentModules
Разложение=Decomposition
РазложитьНОД=DecomposeNode
РазмерМетаданных=MetadataSize
РазмерМетаданныхПриложения=ApplicationMetadataSize
РазмерНебольшогоФайла=SmallFileSize
РазмерОбъектовМетаданных=SizeOfMetadataObjects
РазместитьРисунокВТабличномДокументе=PlaceFigureInSpreadsheetDocument
РазницаВРазмере=SizeDifference
РазрабатываемаяПодсистема=SubsystemUnderDevelopment
РазрешенныеНеаккредитованныеУЦ=AllowedNonAccreditedUS
РазрешенныеПоляДляИзменения=AllowedFieldsToChange
РазрешенныйНеаккредитованный=AllowedUncredited
РазрешитьВнешнийРесурс=AllowExternalResource
РазрядностьДробнойЧастиЗначение=BitDepthOfFractionalPartValue
Разрядов=Discharges
Район=District
РасписаниеВечер=EveningSchedule
РасписаниеДень=ScheduleDay
РасписаниеНочь=ScheduleNight
РасписаниеПроверкиНаличияОбновления=ScheduleForCheckingForUpdates
РаспознанныеЭлементы=RecognizedElements
РасположениеИтогов=TotalsPlacement
РасположениеПриложения=ApplicationLocation
РассмотреноНаСервере=ReviewedOnServer
РассчитанныеПрава=CalculatedPermissions
РассчитанныеПраваПоВладельцам=CalculatedPermissionsByOwners
РассчитатьРазмерПриложения=CalculateApplicationSize
РасходнаяНакладная=ExpenseToPrint
Расчет=Calculation
РасчетРазмераПриложения=CalculatingApplicationSize
РасчетРазмераПриложенияЗавершение=CalculatingApplicationSizeCompletion
РасширениеДляВосстановления=ExtensionForRecovery
РасширениеОбласти=AreaExpansion
РасширениеПакетаXDTO=PackageExtensionXDTO
РасширениеФорматаИзПравилаКонвертации=FormatExtensionFromConversionRule
РасширенияСеанса=SessionExtensions
РасширенияТекущейОбластиДанных=CurDataAreaExtensions
РасширенныеДанныеДляПечатиСертификата=ExtendedDataForCertificatePrint
РасширитьСписокПолей=ExpandFieldList
РасшифроватьБлок=DecryptBlock
РасшифровкаПоДетальнымЗаписям=TranscriptionByDetailedRecords
РасшифровкиКолонок=TranscribeColumns
РасшифровкиСтрок=StringExplanations
РегистрацияВСервисе=RegistrationInService
РегистрацияИнформационнойБазыСистемыВзаимодействия=RegistrationInformationBaseSystemInteractions
РегистрБухгалтерии_ДемоОсновнойДвиженияССубконто=AccountingRegisterDemoOfTheMainMovementWithSubKonto
РегистрируемыеОбработчики=RegisteredHandlers
РегистрСведенийНезависимый=InformationRegisterIndependent
РегистрСимволов=CharacterRegister
РегламентПроектаНачалоВыбора=ProjectRegulationsStartOfSelection
РегламентПроектаОткрытие=RegulationsOfTheOpeningProject
РедактированиеКомментарияВерсииИсторииДанных=EditingCommentVersionDataHistory
РеестрИмен=RegistryNames
РежимАвтоматическойПроверкиНаличияОбновленийПрограммы=AutomaticCheckForProgramUpdates
РежимОсновногоОкнаВстроенноеРабочееМесто=MainWindowModeEmbeddedWorkspace
РежимОсновногоОкнаКиоск=MainWindowModeKiosk
РежимОсновногоОкнаОбычный=MainWindowModeNormal
РежимОсновногоОкнаПолноэкранноеРабочееМесто=MainWindowModeFullScreenWorkspace
РежимОсновногоОкнаРабочееМесто=MainWindowModeWorkspace
РежимСинхронизацииДанныхПриИзменении=DataSynchronizationModeWhenChanging
РежимФормыПриИзменении=FormModeWhenChanging
РезервнаяКопияОбласти=BackupArea_
РезервнаяКопияОбластиДанных=BackupDataArea_
РезультатВыбораПользователя=UserSelectionResult
РезультатДлительнойОперации=ResultLongOperation
РезультатКомпоновки=LayoutResult
РезультатКонтекстнойНастройки=ResultContextSettings
РезультатОбмена=ExchangeResult
РезультатПереноса=TransferResult
РезультатПоискаВзаимодействийПолнотекстовымПоиском=InteractionSearchResultFullTextSearch
РезультатПолученияКэша=ResultOfGettingTheCache
РезультатПроверкиКода=CodeReviewResult
РезультатПроверкиСертификата=CertificateVerificationResult
РезультатПроверкиУдостоверяющегоЦентра=CertificationAuthorityAuditResult
РезультатПроверкиУдостоверяющегоЦентраПоУмолчанию=DefaultCAVerificationResult
РезультатПроверкиУдостоверяющегоЦентраСертификата=ResultofCertificateAuthorityVerification
РезультатПроверкиУЦ=ResultCheckCA
РезультатШтрихкод=ResultBarcode
РезультатыЗамеровКоманднаяПанель=MeasurementResultsCommandPanel
РезультатыЗамеровКонтекстноеМенюОчиститьРезультаты=MeasurementResultsContextMenuClearResults
РезультатыЗамеровСостояниеПросмотра=MeasurementResultsViewingStatus
РезультатыЗамеровСтрокаПоиска=MeasurementResultsSearchBar
РезультатыЗамеровУправлениеПоиском=MeasurementResultsSearchManagement
РезультатыОбмена=ExchangeResults
РеквизитВРоли=AttributeInRole
РеквизитНаименованиеЯзык1=RequisiteNameLanguage1
РеквизитНаименованиеЯзык2=RequisiteNameLanguage2
РеквизитПериод=PropsPeriod
РеквизитыИспользоватьНСтр=AttributesUseNStr
РеквизитыПометка=AttributesCheck
РеквизитыСпискаИсточниковДоступныхПолей=SourceListAvailableFieldsAttributes
РекомендуемыеТарифы=RecommendedRates
Рекомендуемый=Recommended_
РодительВладельцаИлиПользователяНастроек=ParentOwnerOrUserSettings
РодительКлючВарианта=ParentVariantKey
Родительный=Genitive
РолиВыбранныхПрофилей=RolesofSelectedProfiles
РолиОсновныхПрофилей=MainProfileRoles
РолиПоИдентификаторам=RolesByIds
РолиПоКлючам=RolesByKeys
РолиПоКлючамОбъектовМетаданных=RolesByKeysMetadataObjects
РолиСеанса=SessionRoles
РольПроверяющегоНажатие=TheRoleOfTheClickChecker
РучнойПорядок=ManualOrder
СайтСсылка=SiteLink
СброситьЗаполнениеПредставлений=ResetInfillViews
СброситьПометкиСтекаНастроек=ResetStackNotesSettings
СброситьПрогрессВыполненияОбработчиков=ResetProgressProgressHandlers
СброситьСостояниеОбработчика=ResetHandlerState
СведенияОбИБ=InformationAboutInformationSecurity
СведенияОбИБДляИнтеграции=InformationAboutInformationSecurityForIntegration
СведенияОбОрганизации=CompanyInformation
СведенияОбУчастникеРасчетов=InformationAboutSettlementParticipant
СведенияОВладельцахПрисоединенныхФайлов=InformationAboutTheOwnersOfAttachedFiles
СведенияОСертификате=InformationAboutCertificate
СведенияОСертификатеСтрокой=DetailsCertificateString
Свернута=Collapsed_
СвойстваАвторизации=AuthorizationProperties
СвойстваМенюИзСтруктурыОтчета=MenuPropertiesFromReportStructure
СвойстваНабораНачальногоЗаполнения=InitialFillSetProperties
СвойстваОбслуживаемогоАбонента=PropertiesOfServedSubscriber
СвойстваОтбора=SelectionProperties
СвойстваОтбораОбработчикаРасшифровкиПоДетальнымЗаписям=DecryptionHandlerSelectionPropertiesByDetailRecords
СвойстваПодписей=PropertiesSignatures
СвойстваПодпискиНаТариф=TariffSubscriptionProperties
СвойстваСертификатаСтрокой=PropertiesCertificateString
СвойстваСправочников=PropertiesOfDirectories
СвойстваУчетнойСистемы=AccountingSystemProperties
СвойстваЭлементаОтбора=SelectionItemProperties
СвойстваЭлементаОтбораОбработчикаРасшифровки=PropertiesElementSelectionHandlerDecryption
СвойствоВключатьВКомандныйИнтерфейс=PropertyIncludeInCommandInterface
СвязиПриложенийВыбор=ApplicationsLinksSelection
СвязиПриложенийДобавить=ApplicationsLinksAdd
СвязиПриложенийИзменить=ApplicationsLinksChange
СвязиПриложенийКоманднаяПанель=ApplicationsLinksCommandBar
СвязиПриложенийПередНачаломДобавления=ApplicationsLinksBeforeAddRow
СвязиПриложенийПередНачаломИзменения=ApplicationsLinksBeforeRowChange
СвязиПриложенийПередУдалением=ApplicationsLinksBeforeDeleteRow
СвязиПриложенийСостояниеПросмотра=ApplicationsLinksViewStatus
СвязиПриложенийСтрокаПоиска=ApplicationsLinksSearchString
СвязиПриложенийУдалить=ApplicationsLinksDelete
СвязиПриложенийУправлениеПоиском=ApplicationsLinksSearchControl
СгенерироватьПроверочныйКод=GenerateVerificationCode
СервисИнтеграции=ServiceIntegration
СервисКриптографииDSSASNКлиентСервер=DssasnClientServerCryptographyService
СертификатПеревыпущен=CertificateReissued
СертификатПомеченКакОтозванный=CertificateMarkedasRevoked
СертификатПоследнейМеткиВремени=CertificateLastTimestamp
СертификатыПользователя=UserCertificates
СЗаписьюКлючаДляЗависимыхСписковБезКлючей=WithKeyEntryForDependentListsWithoutKeys
СЗаписьюКлючаДоступаДляЗависимыхСписковБезКлючей=WithAccessKeyEntryForDependentListsWithoutKeys
СИ=Si
СИдентификаторами=withidentifiers
СимволыИмениПеременной=VariableNameCharacters
СинонимыПодсистем=SynonymsOfSubsystems
СинхронизацияДанныхЧерезУниверсальныйФормат=DataSynchronizationViaUniversalFormat
СистемныеПроверкиУчета=SystemChecksAccounting
СКЗИ=CIPF
СКЗИ_УЦ=CIPF_UC
СкладПриИзменении=WarehouseOnChange
СкладыКоманднаяПанель=WarehousesCommandBar
СкладыСостояниеПросмотра=WarehousesViewStatus
СкладыСтрокаПоиска=WarehousesSearchString
СкладыУправлениеПоиском=WarehousesSearchControl
СкомпоноватьДанные=ComposeData
СкопироватьМультиязычныеЗначенияВРеквизитыШапки=CopyMultilingualValuesInDetailsCaps
СкрыватьКомандуРазблокировкиОбъекта=HideObjectUnlockCommand
СледующаяКоманда=Next_Command
СлужебнаяСохранитьДанныеАутентификации=ServiceSaveAuthenticationData
СлужебнаяУчетнаяЗаписьDSS=ServiceAccountDSS
СлужебнаяУчетнаяЗаписьDSSАдрес=ServiceAccountDSSSaddress
СлужебныйОбщегоНазначения=UtilityGeneralPurpose
СнятьПометкуЗависимыхПодсистемЗавершение=UncheckDependentSubsystemsCompletion
СнятьПометкуЗависитОтПодсистемЗавершение=UncheckDependsOnSubsystemsCompletion
СнятьСМониторинга=RemoveFromMonitoring
СобранноеЧисло=CollectedNumber
СобратьКодПользователя=CollectUserCode
СобратьЧисло=CollectNumber
СобытиеHTTPЗапрос=HTTPRequestEvent
СобытиеЖурналаРегистрацииОчисткаФайлов=LogEventRegistrationClearFiles
СобытиеЖурналаРегистрацииРазобратьБуферОперацийСтатистики=LogLogEventParseOperationBufferStatistics
СобытияНастроек=EventsSettings
СобытияНастроекИсключения=EventSettingsExceptions
СогласенПриИзменении=AgreeOnChange
СОграничением=withlimit
СодержимоеСертификата=CertificateContents
СодержитВстроеннуюЛицензиюКриптоПро=ContainsEmbeddedLicenseCryptoPro
СоединениеСМенеджеромСервисаИзЛокальнойБазы=ConnectingToServiceManagerFromLocalDatabase
СоединенияЗапроса=RequestConnections
создания=Creation
СоздатьОбновитьУчетнуюСистемуБиллинга=CreateUpdateBillingAccountSystem
СоздатьПодпискуНаОсновнойТариф=CreateSubscriptionToMainTariff
СоздатьПодпискуНаРасширениеТарифа=CreateSubscriptionToTariffExtension
СоздатьПользователяСАдминистративнымиПравами=CreateUserWithAdministrativeRights
СоздатьПользователяСервисаЗавершение=CreateServiceUserCompletion
СоздатьПриложениеИзФайла=CreateApplicationFromFile
СоздатьРезервнуюКопиюПриИзменении=CreateBackupWhenChanging
СоздатьРезервнуюКопиюУстановленоПриИзменении=CreateBackupCopyInstalledWhenModified
СоздатьСчетНаОплату=CreatePaymentInvoice
СоздатьЭлементыФормыДляВложенногоФайла=CreateFormElementsForAttachedFile
СократитьКлючНазначенияИспользования=ShortenUseDestinationKey
СокращенноеИмяФайла=AbbreviatedFileName
СокращенныйКлючНазначенияИспользования=ShortcutUseDestinationKey
СообщениеИнтерактивныйЗапускВыгрузкиВСводноеПриложение=MessageInteractiveStartOfUploadToSummaryApplication
СообщениеИнтерактивныйЗапускВыгрузкиВСводноеПриложениеВыполнен=MessageInteractiveStartOfUploadToSummaryApplicationCompleted
СообщениеИнтерактивныйЗапускЗагрузкиВСводноеПриложение=MessageInteractiveStartLoadingToSummaryApplication
СообщениеНастроитьВыгрузкуВСводноеПриложение=ConfigureUploadToSummaryAppMessage
СообщениеНастроитьЗагрузкуВСводноеПриложение=MessageConfigureUploadToSummaryApp
СообщениеНастройкаВыгрузкиВСводноеПриложениеВыполнена=MessageUploadToSummaryApplicationSetupCompleted
СообщениеНастройкаВыгрузкиВСводноеПриложениеУдалена=MessageUploadToSummaryApplicationSettingsRemoved
СообщениеОтПользователя=MessageFromUser
СообщениеОшибка=ErrorMessage_
СообщениеОшибкаНастройкиВыгрузкиВСводноеПриложение=ErrorMessageConfiguringUploadingToSummaryApp
СообщениеПроверки=VerificationMessage
СообщитьВерсиюКомпонентыПослеПодключения=ReportComponentVersionAfterConnecting
СообщитьОбОшибкеПодключения=ReportConnectionError
СообщитьОбОшибкеФайлНеНайден=ReportErrorFileNotFound
СообщитьРезультатПодключенияКомпоненты=ReportResultConnectionsComponents
СопоставитьПользователей=MatchUsers
Сопоставлено=Matched
СоставЗаголовка=HeaderComposition
СоставМетода=MethodComposition
СоставнаяЗагрузка=MultipartUpload
СоставНовогоПланаОбмена=CompositionOfNewExchangePlan
СостояниеАктивен=ActiveState
Состояниеизвестно=Statesknown
СостояниеРасширения=ExtensionState
СостояниеРегистрацииВСервисеПриИзменении=StateOfRegistrationInServiceWhenChanging
СостоянияЗавершенияПодписокНаТарифы=StatesOfCompletionOfTariffSubscriptions
СостоянияЗаявления=StatementStates
СостоянияЗаявленияНаВыпускСертификата=StatesOfCertificateApplication
СостоянияЗаявленияНеВРаботе=StatusApplicationIsNotInOperation
СостоянияЗаявленияПустаяСсылка=StatementStatusEmptyRef
СотрудникиДатаНачала=EmployeesStartDate
СотрудникиДатаНачалаОкончанияПриИзменении=EmployeesStartEndDateWhenModified
СотрудникиДатаНачалаПриИзменении=EmployeesStartDateAtChange
СотрудникиДатаОкончания=EmployeesEndDate
СотрудникиДатаОкончанияПриИзменении=EmployeesEndDateInCaseOfChange
СотрудникИзТЧ=EmployeeFromPM
СотрудникиКоличествоДней=EmployeesNumberOfDays
СотрудникиКоманднаяПанель=Employees_CommandBar
СотрудникиПредоставитьЕдиновременнуюВыплатуКОтпуску=EmployeesProvideAOneTimePaymentForVacation
СотрудникиСостояниеПросмотра=Employees_ViewStatus
СотрудникиСотрудник=Employees_Employee
СотрудникиСотрудникПриИзменении=Employees_EmployeeOnChange
СотрудникиСотрудникПриИзмененииНаСервере=EmployeesEmployeeWhenChangingOnServer
СотрудникиСтрокаПоиска=Employees_SearchString
СотрудникиУправлениеПоиском=Employees_SearchControl
СохраненнаяВерсия=SavedVersion
СохраненныйОтвет=SavedResponse
СохранитьКодПользователя=SaveUserCode
СохранитьКодПользователяНаКомпьютере=SaveUserCodeOnComputer
СохранитьОтветПользователяНаСервере=SaveUserSResponseToServer
СохранитьПоток=SaveStream
СохраняемыеПараметрыФормыОтчета=StoredReportFormParameters
СохранятьДистрибутивыКомпонентаПлатформыВКаталог1ПриИзменении=SaveDistributionsOfPlatformComponentToDirectory1WhenChanging
СохранятьДистрибутивыКомпонентаПлатформыВКаталогПриИзменении=SaveDistributionsOfPlatformComponentToCatalogWhenChanging
СочетаниеКлавишОтменыДействия=KeyboardShortcutCancelAction
СочетаниеКлавишПовтораДействия=KeyboardShortcutRepeatAction
СочетаниеКлавишУстановлено=KeyboardShortcutSet
СПАРКРиски=SparkRisks
СПечатнымиФормами=PrintedForms
Список_ПередНачаломИзменения=List_BeforeStartChanges
Список_ПриНачалеИзменения=List_AtStartChanges
СписокВалют=ListOfCurrencies
СписокВзаимодействийXDTO=ListOfXDTOInteractions
СписокВидовСравнения=ViewListComparison
СписокВыбираемыхЗначенийSearchControl=ListOfSelectableSearchControlValues
СписокВыбираемыхЗначенийSearchControlContextMenu=ListOfSelectableValuesSearchControlContextMenu
СписокВыбираемыхЗначенийSearchString=ListOfSelectableSearchStringValues
СписокВыбираемыхЗначенийSearchStringContextMenu=ListOfSelectableValuesSearchStringContextMenu
СписокВыбираемыхЗначенийViewStatus=ListOfViewStatusValuesToSelect
СписокВыбираемыхЗначенийViewStatusContextMenu=ListOfSelectableValuesViewStatusContextMenu
СписокВыбираемыхЗначенийКоманднаяПанель=ListOfSelectedValuesCommandBar
СписокДокументовВыбор=DocumentsListSelection
СписокДокументовДатаДокументаИБ=DocumentsListIBDocumentDate
СписокДокументовДатаПервичногоДокумента=DocumentsListSourceDocumentDate
СписокДокументовКоманднаяПанель=DocumentsListCommandBar
СписокДокументовПриАктивизацииСтроки=DocumentsListOnActivateRow
СписокДокументовСостояниеПросмотра=DocumentsListViewStatus
СписокДокументовСтрокаПоиска=DocumentsListSearchString
СписокДокументовУправлениеПоиском=DocumentsListSearchControl
СписокИменОбъектовМетаданных=MetadataObjectNamesList
СписокИменРолейПрофилей=ListRoleNamesProfiles
СписокКонтекстноеМенюЗаменитьИУдалить=ContextMenuListReplaceAndDelete
СписокМетаданныхДляОбработки=MetadataListToProcess
СписокОбъектовКОбработкеДляПереходаНаНовуюВерсию=ListOfObjectsToBeProcessedToUpgradeToNewVersion
СписокОрганизацийКоманднаяПанель=CompaniesListCommandBar
СписокОрганизацийСостояниеПросмотра=CompaniesListViewStatus
СписокОрганизацийСтрокаПоиска=CompaniesListSearchString
СписокОрганизацийУправлениеПоиском=CompaniesListSearchControl
СписокПредставление=ListPresentation
СписокПриложенийПометкаПриИзменении=ApplicationsMarkListOnChange
СписокПрофилей=ProfileList
СписокПрофилейБезГрупп=ProfileListWithoutGroups
СписокРеализацийКоманднаяПанель=ListOfImplementationsCommandPanel
СписокРеализацийСостояниеПросмотра=ListOfImplementationsViewState
СписокРеализацийСтрокаПоиска=ListOfImplementationsSearchString
СписокРеализацийУправлениеПоиском=ListOfSearchManagementImplementations
СписокРезервныхКопийПриложения=ListOfApplicationBackups
СписокСертификатов=CertificatesList
СписокСчетовНаОплату=ListOfInvoices
СписокУсловий=ListOfConditions
СписокУчетныхСистем=ListOfAccountingSystems
СписокФайловXDTO=ListOfXDTOFiles
СписокФайловДанных=DataFileList
СписокФайловДляЗагрузки=ListOfFilesToDownload
СПолями=WithFields
СПометкойУдаления=WithDeletionTagged
СпособВыгрузка=UploadMethod
СпособИсправления=WayFix
СпособМиграция=MethodMigration
СпособПодтвержденияКриптооперацийПриИзменении=CryptoOperationsConfirmationMethodOnChange
СпособРегистрацииПриИзменении=RegistrationMethodOnChange
СпособУказанияРеквизитовБанкаПриИзменении=MethodOfSpecifyingBankSAttributesWhenChanging
СпособУказанияРеквизитовБанкаРасчетовПриИзменении=MethodOfSpecifyingAttributesOfSettlementBankWhenChanging
СпособУстраненияПрименим=RemedyApplicable
СпособФайл=MethodFile
СпособыГруппировки=GroupingMethods
Справочник__ДемоНоменклатура_Общие=Catalog___Products_General
Справочник_ДемоКонтактныеЛицаПартнеров=Catalog_DemoPartnersContactPersons
Справочник_ДемоКонтрагенты=Catalog_DemoCounterparties
Справочник_ДемоНоменклатура=ReferenceDemoNomenclature
Справочник_ДемоПартнеры=Catalog_DemoPartners
Справочник_ДемоПроекты=DirectoryOfDemoProjects
Справочник_КодТНВЭД_Из_Структуры=ReferenceHSCode_From_Structure
Справочник_НомерГТД_Из_Структуры=Reference_NumberGTD_From_Structure
СправочникОбработчикиОчередиЗаданий=TaskQueueHandlersReference
СправочникСсылка_СтраныМира_Отправка=ReferenceReference_CountriesWorld_Sending
СправочникСТЧПредставления=DirectoryofSTCHRepresentations
СравниваемыеДокументы=ComparableDocuments
СравнитьМакетыРолейEDTXML=CompareEdtxxxRoleTemplates
СравнитьФайлыОбработкаРезультата=CompareFilesProcessingResult
СрокЖизни=LifeSpan
СрокХранения=ShelfLife
СсылкаДляОпределенияТипа=ReferenceForTypeDefinition
СсылкаИлиПолноеИмяМетаданных=ReferenceOrFullMetadataName
СсылкаНаДанныеАвторизации=LinkToAuthorizationData
СсылкаНаКартинку=ImageLink
СсылкаНаНастройку=LinkToSettings
СсылкаНаПоследнийОбработанныйОбъекты=ReferenceToLastProcessedObjects
СсылкаНаРодителя=ReferenceToParent
СсылкаНаСайт=LinkToWebsite
СсылкаНаСтатьюОбУдостоверяющихЦентрах=LinktothearticleonCAs
СсылкаНаСтраницу=LinkToPage
СсылкаПовторитьПопыткуПередачиДанных=RetryDataTransferLink
СсылкаПовторитьПопыткуСозданияПриложения=RetryAppCreationLink
СсылкиНаОбъектыМетаданных=ReferencesToMetadataObjects
СсылкиНаОбъектыМетаданныхТребующиеОбработки=ReferencesToMetadataObjectsRequiringProcessing
СсылкиНаТипы=ReferencesToTypes
Ссылочные=ReferenceItems
СсылочныеТипыДобавляемыеРасширениями=ReferenceTypesAddedByExtensions
СсылочныеТипыРасширений=ReferenceTypesOfExtensions
Стандарт=Standard_
СтандартнаяОбработкаБиблиотекой=StandardLibraryProcessing
СтандартнаяОбработкаФормой=StandardFormProcessing
СтандартнаяПроцедураПроверки=StandardCheckProcedure
СтандартныеРоли=StandardRoles
СтандартныеРолиПрофиля=StandardProfileRoles
СтандартныйПрефиксСокращенный=StandardPrefixAbbreviated
СтароеЗадание=OldAssignment
СтарыеВидыДоступа=OldAccessTypes
СтарыеЗначенияДоступа=OldAccessValues
СтарыйГлавныйУзел=OldMasterNode
СтатусИзмененаПроцедураПроверки=StatusChangedCheckProcedure
СтатусОбработчика=ProcessorStatus
СтатусОжидания=StatusWaiting
СтатусОповещения=AlertStatus
СтекНастроекОтчета=StackReportSettings
СтранаПроисхожденияОбработкаВыбора=CountryOfOriginSelectionProcessing
СтранаРегистрацииОбработкаВыбора=CountryOfRegistrationProcessingOfSelection
СтраницаОграничениеПоВладельцуБезОптимизации=PageOwnerRestrictionWithoutOptimization
СтраницаОграничениеПоВладельцуНеРассчитано=PageOwnerRestrictionNotCalculated
СтраницаОграничениеПоВладельцуСОптимизацией=PageOwnerRestrictionWithOptimization
СтраховойНомерПФР=InsuranceNumberOfTheFIU
СтрогаяПроверка=StrictVerification
СтрокаHTTPСервисы=StringHTTPServices
СтрокаUTF8=StringUTF8
СтрокаWebСервисы=StringWebServices
СтрокаАвтоподбораОрганизации=OrganizationAutoSelectionLine
СтрокаБизнесПроцессы=StringBusinessProcesses
СтрокаВидДоступаОбъект=StringAccessTypeObject
СтрокаВложения=StringAttachments
СтрокаВложенныеПодсистемы=StringNestedSubsystems
СтрокаВнешнееСоединение=ExternalConnectionString
СтрокаВнешниеИсточникиДанных=StringExternalDataSources
СтрокаВозвращаемоеЗначение=StringReturnValue
СтрокаВызовСервера=ServerCallString
СтрокаГлава4ПрограммныйИнтерфейс=LineChapter4ProgrammingInterface
СтрокаГруппаДокументы=StringGroupDocuments
СтрокаДляВызоваСКлиента=StringToCallFromClient
СтрокаДляВызоваСКлиентаИСервера=StringToCallFromClientAndServer
СтрокаДляВызоваССервера=StringToCallFromServer
СтрокаДляТекущегоЯзыка=StringForCurrentLanguage
СтрокаДокументы=StringDocuments
СтрокаДоступность=AvailabilityLine_
СтрокаЖурналыДокументов=StringDocumentLogs
СтрокаЗапросаАвторизации=QueryAuthorizationString
СтрокаЗнач=Line1
СтрокаИерархииЕстьПрава=StringHierarchyIsRights
СтрокаИзмерения=MeasurementString_
СтрокаИнтерфейс=LineInterface
СтрокаИсточникДанных=DataSourceRow
СтрокаКлиентИСервер=ClientAndServerString
СтрокаКонецОбласти=LineEndOfArea
СтрокаКонецПроцедуры=LineEndOfProcedure
СтрокаКонецФункции=LineEndOfFunction
СтрокаКонстанты=StringConsts
СтрокаКонтактовОбслуживающейОрганизации=ServiceOrganizationContactLine
СтрокаКонтактовСлужбыПоддержки=SupportContactLine
СтрокаКонфликт=StringConflict
СтрокаКритерииОтбора=StringSelectionCriteria
СтрокаКуба=StringCube
СтрокаЛишнихСимволов=StringOfExtraCharacters
СтрокаМетоды=StringMethods
СтрокаОбласть=StringArea
СтрокаОбластьДляВызоваИзДругихПодсистем=StringScopeForCallingFromOtherSubsystems
СтрокаОбластьУстаревшиеПроцедурыИФункции=ScopeStringObsoleteProceduresAndFunctions
СтрокаОбработчик=RowHandler
СтрокаОбщие=StringGeneral
СтрокаОбщиеКоманды=StringCommonCommands
СтрокаОбщиеРеквизиты=StringGeneralRequisites
СтрокаОбщиеФормы=StringGeneralForms
СтрокаОбщийМодуль=StringCommonModule
СтрокаОперации=OperationString
СтрокаОрганизации=OrganizationString
СтрокаОтвета=ResponseString
СтрокаПараметры=StringParameters_
СтрокаПараметрыСеанса=StringSessionParameters
СтрокаПереопределение=LineOverride
СтрокаПереопределениеОписание=LineOverrideDescription
СтрокаПерерасчеты=StringRecalculations
СтрокаПеречисления=EnumString
СтрокаПланыВидовРасчета=StringPlansViewsCalculation
СтрокаПланыВидовХарактеристик=StringPlansViewsCharacteristics
СтрокаПланыОбмена=StringExchangePlans
СтрокаПланыСчетов=LineOfAccountPlans
СтрокаПодробности=LineDetails
СтрокаПозицияКурсора=LineCursorPosition
СтрокаПоискаЗавершение=SearchStringFinish
СтрокаПолныеПрава=FullRightsLine
СтрокаПолныхИменРолей=StringFullRoleNames
СтрокаПоля=FieldString
СтрокаПоследовательности=StringSequence
СтрокаПрав=StringRight
СтрокаПредопределенныхДанных=StringPredefinedData
СтрокаПредусмотреноДвеФункции=StringProvidesTwoFunctions
СтрокаПризнакиУчета=StringAccountingAttributes
СтрокаПризнакиУчетаСубконто=LineAccountingAttributesSubconto
СтрокаПример=StringExample
СтрокаПримерВызова=StringExampleCall
СтрокаПримерРеализации=StringExampleImplementation
СтрокаПроцедура=StringProcedure
СтрокаРасположение=StringLocation
СтрокаРегистрыБухгалтерии=StringRegistersAccounting
СтрокаРегистрыНакопления=StringRegistersAccumulation
СтрокаРегистрыРасчета=StringRegistersCalculation
СтрокаРегистрыСведений=StringRegistersDetails
СтрокаРеквизитыАдресации=StringRequisitesAddresses
СтрокаРесурсы=LineResources
СтрокаСервер=StringServer
СтрокаСинтаксис=StringSyntax
СтрокаСинтаксисВызоваФункцииРезультат=StringSyntaxOfFunctionCallResult
СтрокаСотрудника=EmployeeString
СтрокаСотрудники=StringEmployees
СтрокаСправочники=StringCatalogs
СтрокаСсылкаНаСтандарты=StringReferenceToStandards
СтрокаСтандартныеРеквизиты=StringStandardAttributes
СтрокаСтандартныеТабличныеЧасти=RowStandardTableParts
СтрокаСтандартныеТабличныеЧастиСтандартныеРеквизиты=RowStandardTablePartsStandardAttributes
СтрокаСФункцией=StringWithFunction
СтрокаТаблицыИдентификаторов=RowTableIdentifiers
СтрокаТаблицыИзмерений=RowTableDimensions
СтрокаТабличныеЧасти=RowTableParts
СтрокаТабличныеЧастиРеквизиты=RowTablePartsAttributes
СтрокаТекущегоЯзыка=StringCurrentLanguage
СтрокаТолстыйКлиент=FatClientLine
СтрокаТолькоДляВнутреннегоИспользования=StringIsForInternalUseOnly
СтрокаТонкийКлиент=StringThinClient
СтрокаФункции=FunctionString
СтрокаФункция=StringFunction
СтрокаХеша=StringHash
СтрокаХешСуммы=StringHashSum
СтрокаШаблоныURL=StringTemplatesURL
СтрокаЭкспорт=ExportLine
СтрокаЯзыка=LanguageString
СтрокиВложения=StringsAttachments
СтрокиЕстьПрава=RowsIsPermissions
СтрокиИсточникДанных=RowsDataSource
СтрокиМеждуКавычками=LinesBetweenQuotes
СтрокиПоиска=SearchBars
СтрокиПравПрофилей=ProfileRightsStrings
СтрокиСФункциями=StringsWithFunctions
СтрокиХранятсяВТабличнойЧасти=RowsStoredinTablePart
СтрРазделитьСУчетомСтрок=RowSplitConsideringRows
СтруктураПараметровВыгрузкиДанных=DataUploadParameterStructure
СтруктураПараметровЗаписиПакетаУстановки=StructureSettingsPacketRecords
СтруктураПараметровУдаленияФайла=FileDeleteParameterStructure
СтуктураОтбора=StukturaOfSelection
СубъектыСоКрытымиПДн=SubjectsWithCoveredNDN
СуммаНачальныйОстатокДт=SumOpeningBalanceDr
СуммаНачальныйОстатокКт=SumOpeningBalanceCr
СуммаОборотДт=SumTurnoverDr
СуммаОборотКт=SumTurnoverCr
СуффиксВторогоЯзыка=SecondLanguageSuffix
СуффиксКлючаНастройки=SuffixKeySettings
СуффиксОтключеннойФункции=SuffixDisabledFunctions
СуффиксПервогоЯзыка=FirstLanguageSuffix
СуффиксЯзыкаТекущегоПользователя=CurrentUserLanguageSuffix
СуществующаяКопия=ExistingCopy
СуществующиеПоставляемыеЭлементы=ExistingSuppliedItems
СуществующиеЭлементы=ExistingItems
СформироватьВзаимодействиеXDTO=GenerateXDTOInteraction
СформироватьДвижениеПоступленияТовараПоРегиструОсновной=GenerateMovementOfReceiptOfGoodsByRegisterOfMain
СформироватьДвижениеПоступленияТовараПоРегиструОсновнойБезКорреспонденции=ToFormMovementOfReceiptOfGoodsByRegisterOfMainWithoutCorrespondence
СформироватьДвижениеРеализацииТовараПоРегиструОсновной=ToFormMovementOfSaleOfGoodsAccordingToRegisterOfMain
СформироватьДвижениеРеализацииТовараПоРегиструОсновнойБезКорреспонденции=ToFormMovementOfSaleOfGoodsAccordingToRegisterOfMainOneWithoutCorrespondence
СформироватьДвижениеУчетаВходящегоНДСПоРегиструОсновной=GenerateMovementOfIncomingVATAccountingAccordingToBasicRegister
СформироватьДвижениеУчетаВходящегоНДСПоРегиструОсновнойБезКорреспонденции=GenerateMovementOfIncomingVATAccordingToBasicRegisterWithoutCorrespondence
СформироватьДвижениеУчетаНачисленногоНДСПоРегиструОсновной=GenerateMovementOfAccountingForAccruedVATAccordingToBasicRegister
СформироватьДвижениеУчетаНачисленногоНДСПоРегиструОсновнойБезКорреспонденции=GenerateMovementOfAccountingForAccruedVATAccordingToBasicRegisterWithoutCorrespondence
СформироватьНаСервере=GenerateOnServer
СформироватьОтчетПродолжение=GenerateReportContinued
СформироватьПечатнуюФормуТ6а=ToFormPrintedFormT6A
СформироватьПослеПредупреждения=GenerateAfterWarning
СформироватьСловарьПолныхПутейКФормамВМоделиСервиса=CreateDictionaryOfCompletePathsToFormsInServiceModel
СформироватьСписокФайловXDTO=GenerateListOfXDTOFiles
СформироватьСтраницу=GeneratePage
СформироватьТабличныйДокумент=GenerateSpreadsheetDocument
СхемаSSL=SSLScheme
СхемаДанныеПечатиМультиязычныеРеквизиты=SchemaDataPrintingMultilanguageRequisites
СхемаДанныеПечатиСуммаПрописью=SchemaDataPrintAmountWords
СхемаДанныеПечатиФамилияИнициалы=SchemeDataPrintsLastNameInitials
СхемаКомпоновкиДанныхДополнительныхРеквизитовИСведений=LayoutSchemeDataAdditionalDetailsAndDetails
СхемаКомпоновкиДанныхКонтактнойИнформации=DataLayoutSchemaContactInformation
СхемаКомпоновкиДанныхПечати=SchemaCompositionDataPrint
СхемаСсылки=LinkDiagram
Схемы=Schemes
СхемыКомпоновкиДанных=DataCompositionSchemas
СхемыКомпоновкиДанныхИсточникаПолей=FieldsSourceDataCompositionSchemes
СценарийОбменаОбъект=ObjectSharingScenario
СчетаНаОплатуSearchControl=SearchControlInvoices
СчетаНаОплатуSearchControlContextMenu=InvoicesForPaymentSearchControlContextMenu
СчетаНаОплатуSearchString=SearchStringInvoices
СчетаНаОплатуSearchStringContextMenu=InvoicesForPaymentSearchStringContextMenu
СчетаНаОплатуViewStatus=InvoicesForPaymentViewStatus
СчетаНаОплатуViewStatusContextMenu=InvoicesForPaymentViewStatusContextMenu
СчетаНаОплатуКоманднаяПанель=InvoicesForPaymentCommandPanel
СчетаНаОплатуПриИзменении=InvoicesToBePaidInCaseOfChanges
СчетаНаОплатуСостояниеПросмотра=InvoicesForPaymentViewingStatus
СчетаНаОплатуСтрокаПоиска=InvoicesForPaymentSearchBar
СчетаНаОплатуУправлениеПоиском=InvoicesForPaymentSearchManagement
СчетНаОплатуДобавить=InvoicePaymentAdd
СчетНаОплатуИзменить=InvoicePaymentChange
СчетНаОплатуФайлыТалонНаЗагрузку=InvoiceForPaymentAndDownloadCoupon
ТабДок=TabDoc
ТаблицаВладельцевПрисоединенныхФайлов=TableOfOwnersOfAttachedFiles
ТаблицаДатПоКалендарюSearchControl=TableOfDatesByCalendarSearchControl
ТаблицаДатПоКалендарюSearchControlContextMenu=TableOfDatesByCalendarSearchControlContextMenu
ТаблицаДатПоКалендарюSearchString=TableOfDatesByCalendarSearchString
ТаблицаДатПоКалендарюSearchStringContextMenu=TableOfDatesByCalendarSearchStringContextMenu
ТаблицаДатПоКалендарюViewStatus=CalendarDateTableViewStatus
ТаблицаДатПоКалендарюViewStatusContextMenu=CalendarDateTableViewStatusContextMenu
ТаблицаДатПоКалендарюКоманднаяПанель=CalendarDateTableCommandPanel
ТаблицаЗаголовок=TableTitle
ТаблицаЗначенийВМассивСтруктур=TableOfValuesInArrayOfStructures
ТаблицаЗначенийПараметрКоманднаяПанель=TableOfValuesParameterCommandPanel
ТаблицаЗначенийПараметрСостояниеПросмотра=TableOfValuesParameterViewState
ТаблицаЗначенийПараметрСтрокаПоиска=TableOfValuesParameterSearchString
ТаблицаЗначенийПараметрУправлениеПоиском=TableOfValuesParameterSearchManagement
ТаблицаИзмерения=Table_Measurements
ТаблицаКоманднаяПанель=TableCommandBar
ТаблицаПолейДанныхПечати=PrintDataFieldTable
ТаблицаПользователейЗаблокироватьПользователя=UsersTableLockUser
ТаблицаПриоритетов=PriorityTable
ТаблицаРеквизитовВРоли=InRoleDetailsTable
ТаблицаСотрудники=TableEmployees
ТаблицаСсылокКоманднаяПанель=LinkTableCommandPanel
ТаблицыСОтключеннымОграничением=TablesWithRestrictionDisabled
ТабНомер=TabNumber
ТабПредопределенные=TabPredefined
ТактоваяЧастота=ClockFrequency
ТалонНаЗагрузкуФайла=CouponForUploadingFile
Тариф=Tariff
Тарифы=PricingPlans
ТарифыПровайдера=ProviderRates
ТВ=TV
Тег=Tag_
ТекРоль=CurRole
ТекстБезОграничения=TextUnlimited
ТекстВсеЗапрещены=TextAllForbidden
ТекстВсеРазрешены=TextAllAllowed
ТекстВторойСтроки=SecondLineText
ТекстВывода=OutputText_
ТекстВыводаИнформацииОбОшибкеВСлужбеПоддержки=TextOfErrorInformationOutputInSupportService
ТекстДляЗаписиВЖурнал=TextToWriteToLog
ТекстДоВызова=TextBeforeCall
ТекстДолгийЗапрос=TextQuery
ТекстЕстьОграничение=TextIsRestriction
ТекстЗапрещенные=TextForbidden
ТекстЗапрещенныеПользователи=TextForbiddenUsers
ТекстЗапросаБезГруппировкиПоОтчетамСОграничениямиДоступаВидыОграничений=QueryTextWithoutGroupingByReportsWithAccessRestrictionsRestrictionTypes
ТекстЗапросаБезГруппировкиПоОтчетамСОграничениямиДоступаВидыОграниченийПоНовому=QueryTextWithoutGroupingByReportsWithAccessRestrictionsRestrictionTypesNew
ТекстЗапросаБезГруппировкиПоОтчетамСОграничениямиДоступаВидыОграниченийПоСтарому=QueryTextWithoutGroupingByReportsWithAccessRestrictions
ТекстЗапросаБезГруппировкиПоОтчетамСОграничениямиДоступаКонец=QueryTextWithoutGroupingByReportsWithAccessRestrictionsEnd
ТекстЗапросаБезГруппировкиПоОтчетамСОграничениямиДоступаНачало=QueryTextWithoutGroupingByReportsWithAccessRestrictionsStart
ТекстЗапросаДоступныхВариантовОтчетов=QueryTextAvailableReportOptions
ТекстЗапросаМакет=QueryTextTemplate
ТекстЗапросаМультиязычныеРеквизиты=RequestTextMultilingualRequisites
ТекстЗапросаПредставленияНаДругихЯзыкахВТабличнойЧасти=ViewQueryTextInOtherLanguagesInTabularPart
ТекстЗапросаПриоритетыОбновленияТипов=QueryTextTypeUpdatePriorities
ТекстЗапросаРегистра=RegisterRequestText
ТекстЗапросаСпискаСЗащитойПерсональныхДанных=RequestTextForListWithPersonalDataProtection
ТекстИмениФайла=FileNameText
ТекстИндикатора=TextIndicator
ТекстМетки=PlacemarkText
ТекстовыйДокументПолныеПраваИсправленный=TextDocumentFullRightsCorrected
ТекстОграничениеБезВидовДоступа=TextRestrictionWithoutAccessTypes
ТекстОграниченияДляВнешнихПользователейИзменениеТекстаРедактирования=TextRestrictionsForExternalUsersChangingTheEditingText
ТекстОшибкиЧтенияXML=XMLReadingErrorText
ТекстПравоЗапрещено=TextRightForbidden
ТекстПравоНеНазначено=TextRightNotAssigned
ТекстПравоРазрешено=TextRightAllowed
ТекстПредупрежденияИзмененаПроцедураПроверки=TextWarningChangedCheckProcedure
ТекстПредупрежденияОбАктивныхРасширенияхИзменяющихСтруктуруДанных=WarningTextAboutActiveExtensionsThatChangeDataStructure
ТекстПродолжение=TextContinued
ТекстРазрешенные=TextAllowed
ТекстРазрешенныеПользователи=TextAllowedUsers
ТекстСводнаяИнформация=TextSummaryInformation
ТекстШаблонаМакетаПраваПоРолиБезВторойСтроки=TextOfRoleRightsTemplateWithoutSecondLine
ТекстШаблонаМакетаПраваПоЭталонуРолиБезВторойСтроки=TextOfTemplateRightsToRoleReferenceWithoutSecondLine
ТекстШапка=TextHat
ТекстыЗапросаРегистров=RegisterRequestTexts
ТекущаяВысота=CurrentHeight
ТекущаяМинимальнаяВерсия=CurrentMinimumVersion
ТекущаяПодпись=CurrentSignature
ТекущаяПроверка=CurCheck
ТекущееЗначениеКеша=CurrentCacheValue
ТекущееКоличествоЗаписей=CurNumberOfRecords
ТекущееПредставлениеОбъекта=CurrentObjectRepresentation
ТекущиеЗависимыеТаблицы=CurrentDependentTables
ТекущиеИдентификаторы=CurrentIDs
ТекущиеНаименованиеВарианта=CurrentOptionName
ТекущиеНастройкиСтека=CurrentStackSettings
ТекущиеНастройкиСтекаОпределены=CurrentStackSettingsDefined
ТекущиеОписаниеВарианта=CurrentDescriptionOption
ТекущиеСсылкиНаОбъекты=CurrentReferencesToObjects
ТекущийВариант=CurVersion
ТекущийКодЯзыка=CurrentCodeLanguage
ТекущийПутьКОбъекту=CurrentPathToObject
ТекущийШагДоВыполненияОбработчика=CurStepBeforeHandlerExecution
ТекущийЭлементДерева=CurTreeElement
ТекЭлементСостава=CurElementComposition
ТелефонДляПаролейИзменениеТекстаРедактирования=PhoneForPasswordsEditTextChange
ТелефонДляПаролейПриИзменении=PhoneForPasswordsOnChange
ТелефонПокупателя=BuyerSPhoneNumber
ТелефонСсылка=PhoneLink
Территория=Territory
ТестированиеОтложенногоОбновления=TestingDeferredUpdate
ТестовыеОшибкиДобавлены=TestErrorsAdded
Тестовый=Test_
ТипXDTOПравилаКонвертацииИзРасширенийПакетаXDTO=XDTOTypeConversionRulesFromPackageExtensionsXDTO
ТипXDTOПравилаОбработкиИзРасширенийПакетаXDTO=TypeXDTOProcessingRulesFromPackageExtensionsXDTO
ТипВладельцаПрисоединенныхФайлов=OwnerTypeOfAttachedFiles
ТипВладельцаПрисоединенныхФайловОбъект=OwnerTypeOfAttachedFilesObject
ТипВладельцаПрисоединенныхФайловСтрокой=OwnerTypeOfAttachedFilesByString
ТипВФормеНачалоВыбора=TypeInFormStartOfSelection
ТипЗаписьЖР=TypeLRRecording
ТипЗначенияДополнительногоСвойстваПоИмени=ValueTypeOfAdditionalPropertyByName
ТипИдентификатора=IDType
ТипИдентификаторОбъектаМетаданных=TypeMetadataObjectId
ТипИдентификаторРасшифровкиКомпоновкиДанных=DataCompositionDecryptionIdentifierType
ТипИдентификации=IdentificationType
ТипИнтерфейса=InterfaceType
ТипИсключаемыйИзВыгрузкиЗагрузки=TypeExcludedFromUploadUpload
ТипИсполнителяПриИзменении=ArtistTypeWhenChanging
ТипКлючаОбъектаМетаданных=MetadataObjectKeyType
ТипМоделиДанных=DataModelType
ТипОМД=OMDType
ТипОписания=DescriptionType
ТипПартнера=PartnerType
ТипПланаСчетов=ChartOfAccountsType
ТипПодписиЗначение=SignatureTypeValue
ТипПодписиКриптографии=CryptographySignatureType
ТипПодписиСервиса=ServiceSignatureType
ТипПодписываемыеОбъекты=SignedObjectsType
ТипПоказаЗапросаПриИзменении=TypeOfRequestDisplayWhenChanging
ТипПрограммыСервисаПодписи=ServiceProgramTypeSignatures
ТипПустойСсылки=TypeEmptyLinks
ТипРегистрации=TypeOfRegistration
ТипРегистрацииЗапрос=TypeOfRegistrationRequest
ТипРегистрацииПриглашение=TypeOfRegistrationInvitation
ТипРегистрацииРучная=TypeOfRegistrationManual
ТипРуководителя=TypeOfManager
ТипСериализуемоеЗначение=TypeSerializableValue
ТипСпискаФайлов=FileListType
ТипСписокВзаимодействий=TypeListOfInteractions
ТипФиксированнаяСтруктура=TypeFixedStructure
ТипыИзОписанийТипов=TypesFromTypeDescriptions
ТипыИсключаемыеИзВыгрузкиЗагрузки=TypesExcludedFromUnloadingLoading
ТипыМоделиДанных=DataModelTypes
ТипыОбработчиков=HandlerTypes
ТипыОбъектовМетаданныхСсылочногоТипа=TypesOfMetadataObjectsOfReferenceType
ТипыПодписанныйОбъект=TypesOfSignedObject
ТипыТребующиеАннотациюСсылок=TypesRequiringAnnotationOfReferences
ТипЭлементовДанных=TypeDataItem
ТоварыSearchControl=SearchControlProducts
ТоварыSearchControlContextMenu=ProductsSearchControlContextMenu
ТоварыSearchString=ProductsSearchString
ТоварыSearchStringContextMenu=ProductsSearchStringContextMenu
ТоварыViewStatus=ProductsViewStatus
ТоварыViewStatusContextMenu=ProductsViewStatusContextMenu
ТоварыВсего=ProductsTotal
ТоварыВставитьСтроки=GoodsInsertRows
ТоварыДобавить=GoodsAdd
ТоварыЗагрузитьТоварыИзФайла=GoodsImportGoodsFromFile
ТоварыКоманднаяПанель=GoodsCommandBar
ТоварыНоменклатура=GoodsProducts
ТоварыНоменклатураПриИзменении=GoodsProductsOnChange
ТоварыПриИзменении=GoodsOnChange
ТоварыСкопироватьСтроки=GoodsCopyRows
ТоварыСостояниеПросмотра=GoodsViewStatus
ТоварыСтрокаПоиска=GoodsSearchString
ТоварыУдалить=GoodsDelete
ТоварыУправлениеПоиском=GoodsSearchControl
ТолькоАктивные=ActiveOnesOnly
ТолькоИспользуемые=UsedOnly
ТолькоКоличество=OnlyQuantity
ТолькоМонопольные=OnlyExclusive
ТолькоОсновные=OnlyBasic
ТолькоОтложенные=OnlyDeferred
ТолькоСПометкой=MarkedOnly
ТолькоСтраницаВыбораТарифа=FareSelectionPageOnly
ТолькоУказанныйПериод=OnlySpecifiedPeriod
ТорговаяТочка=PointOfSale
ТочностьЧисла=NumberAccuracy
ТребуемаяВерсия=RequiredVersion
ТребуемаяДлина=RequiredLength
ТребуемыеПоля=Required_Fields
ТребуетсяВключитьЗаполнениеПараметровРаботыРасширений=RequiredEnableFillingExtensionsWorkParameters
ТребуетсяДобавитьАрхивныеМетки=RequiredAddArchiveTags
ТребуетсяПодготовкаВнешнегоНабораДанных=RequiresPreparingExternalDataset
ТребуетсяПроверитьАктуальностьМетаданных=YouNeedToCheckRelevanceOfMetadata
ТребуетсяПродлениеСертификата=CertificateRenewalRequired
ТребуетсяУсовершенствоватьПодписи=RequireImprovementSignatures
ТЧПредставления=PMSubmissions
ТЧПредставленияИспользуетсяДляГрупп=PMViewUsedForGroups
УвеличиласьВерсияОбработки=IncreasedProcessingVersion
УвеличитьИнтервал=IncreaseInterval
УдаленПредопределенныйЭлементПапкиИлиПрофиля=PredefinedFolderOrProfileItemHasBeenDeleted
УдалитьВсеПодчиненныеЭлементы=RemoveAllSubordinateElements
УдалитьИзбыточныеЗаписиСтекаНастроек=DeleteRedundantStackEntriesSettings
УдалитьИзбыточныеРасширенияПравилаКонвертации=RemoveRedundantExtensionsConversionRules
УдалитьКомандыМенюПереходаМеждуИзменениямиНастроек=DeleteCommandsMenuTransitionBetweenSettingChanges
УдалитьМакетВидимость=RemoveLayoutVisibility
УдалитьМакетНаСервере=DeleteLayoutOnServer
УдалитьМакетНаТекущемЯзыке=DeleteLayoutInCurrentLanguage
УдалитьМонопольныйРежимНаСервере=RemoveExclusiveModeOnServer
УдалитьНеактуальныеРазделаОтчета=DeleteIdleReportSection
УдалитьНенужныеФайлы=DeleteJunkFiles
УдалитьНесуществующиеПотоки=DeleteNonExistingThreads
УдалитьОбластиПерсональныхДанных=DeleteAreasOfPersonalData
УдалитьОтключенныеЗначения=DeleteDisabledValues
УдалитьПросроченныеЗапросы=DeleteExpiredRequests
УдалитьРазрывСтекаНастроек=RemoveStackBreakSettings
УдалитьРасширенияОбласти=RemoveAreaExtensions
УдалитьСостояниеЗаявления=DeleteStatementStatement
УдалитьУстаревшиеПараметрыРаботыРасширенийНаСервере=DeleteDeprecatedSettingsExtensionsWorkOnServer
УдалитьФайлСервер=DeleteFileServer
УказанаВерсияФайла=FileVersionIsSpecified
УникальноеИмяСПутем=UniqueNameByWay
УникальныеФизлица=UniqueIndividuals
УпакованноеЗначение=PackedValue
УправлениеДоступом_ПроверитьИспользованиеПредопределенныхВМодулеКоманды=AccessControl_CheckUseOfPredefinedInModuleCommands
УправлениеДоступом_ПроверитьИспользованиеПредопределенныхВМодулеФормы=AccessControl_CheckUseOfPredefinedInFormModule
УправлениеДоступом_ПроверитьИспользованиеПредопределенныхВМодуляхОбъекта=AccessControl_CheckUsageOfPredefinedInObjectModules
УправлениеДоступом_ПроверитьИспользованиеПредопределенныхВОбщемМодуле=AccessControl_CheckUseOfPredefinedInSharedModule
УправлениеДоступом_ПроверитьИспользованиеПредопределенныхМодуле=AccessControl_CheckUsageOfPredefinedModule
УправлениеОповещениямиОСертификатах=ManageAlertsCertificates
УправлениеПечатью_=ManagePrint_
УправлениеПечатью_КоличествоСтрок=PrintControl_NumberofLines
УправлениеПечатью_СтрокаЛатиницей=PrintControl_StringLatin
УровеньЗаголовка=HeaderLevel
УровниДоступа=AccessLevels
Условие_=Condition_
УсловиеЗаявления=StatementCondition
УсловиеИспользования=TermsOfUse_
УсловиеНомераШапки=HeaderNumberCondition
УсловиеПоВремени=TimeCondition
УсловияВидимостиПоТипамОбъектов=VisibilityConditionsByObjectTypes
УсловияВыбора=SelectionConditions
УсловияОграниченияСинхронизацииОрганизаций=ConditionsForRestrictingOrganizationSynchronization
УсловияОграниченияСинхронизацииПодразделений=ConditionsForRestrictingSynchronizationOfDivisions
УсловияОграниченияСинхронизацииСкладов=ConditionsForLimitingWarehouseSynchronization
Усовершенствование=Improvement
УсовершенствованиеПроизошло=ImprovementHappened
УсовершенствоватьДоТипа=RefineToType
УсовершенствоватьНаСервере=RefineOnServer
УсовершенствоватьНаСтороне=RefineSide
УсовершенствоватьНаСторонеПослеОшибки=RefineSideAfterError
УсовершенствоватьНаСторонеПослеПолученияКонтейнераПодписи=Refineonthesideafterreceivingthecontainersignature
УсовершенствоватьНаСторонеПослеПроверкиСертификатаПодписи=RefineSideAfterVerifyingCertificateSignature
УсовершенствоватьНаСторонеПослеСозданияМенеджераКриптографии=RefineOnTheSideAfterCreationCryptographyManager
УсовершенствоватьНаСторонеПослеЦикла=RefineOnSideAfterCycle
УсовершенствоватьНаСторонеСервера=EnhanceServerSide
УсовершенствоватьНаСторонеЦиклНачало=RefineSideLoopStart
УсовершенствоватьНаСторонеЦиклНачалоПродолжение=RefineSideLoopStartContinuation
УсовершенствоватьНаСторонеЦиклПослеОперацииНаКлиенте=RefineSideLoopAfterOperationClient
УсовершенствоватьНаСторонеЦиклПослеОшибкиОперацииНаКлиенте=ImproveOnSideLoopAfterErrorOperationsOnClient
УсовершенствоватьПодпись=RefineSignature
УсовершенствоватьПодписьВСервисе=RefineSignatureInService
УсовершенствоватьПодписьОбъекта=ImproveObjectSignature
УсовершенствоватьПослеВыполненияНаСторонеКлиента=RefineAfterExecutionOnClientSide
УсовершенствоватьПослеВыполненияНаСторонеСервера=RefineAfterRunningServerSide
УсовершенствоватьРегламентнымЗаданием=ImproveRegularTask
УстановитьВидимостьПоСостояниюОбновления=SetVisibilityByUpdateState
УстановитьВыводКолонтитула=SetHeaderAndFooterOutput
УстановитьЗаголовокПодсказкиУсовершенствования=SetHeaderTipsImprovements
УстановитьЗаголовокЭлектроннаяПодписьНаСервере=SetHeaderElectronicSignatureOnServer
УстановитьЗапросСписка=SetListRequest
УстановитьИспользованиеМакета=SetUseLayout
УстановитьИсправленияПриИзменении=InstallFixesWhenChanging
УстановитьКлючСохраненияПоложенияОкна=SetKeyToSaveWindowPosition
УстановитьКодЯзыка=SetLanguageCode
УстановитьКонтролыПоУмолчанию=SetDefaultControls
УстановитьКурсорВШаблонеТекста=SetCursorInTextTemplate
УстановитьНастройкиВхода=SetLoginSettings
УстановитьНастройкиДобавить=InstallSettingsAdd
УстановитьОграничениеТипа=SetRestrictionType
УстановитьОформлениеПоляТипаДополнительногоСвойства=SetAppearanceOfAdditionalPropertyTypeField
УстановитьОформлениеФлажка=SetCheckboxStyle
УстановитьПараметрыВСпискеСертификатов=SetParametersInCertificateList
УстановитьПараметрыВСпискеСертификатовНаСервере=SetParametersInCertificateListOnServer
УстановитьПараметрыРедактированияЭлементаОтбора=SetFilterElementEditOptions
УстановитьПодключитьСообщитьВерсиюКомпоненты=InstallConnectReportVersionComponents
УстановитьПризнакИспользованияВыгрузкиДанныхВСводноеПриложение=SetWhetherToUseUploadingDataToSummaryApplication
УстановитьПримерыЗначений=SetExamplesValues
УстановитьРасписаниеРегламентногоЗаданияЗагрузкиИсправлений=SetAScheduleForTheRoutineTaskOfDownloadingFixes
УстановитьРасписаниеУдаленияПомеченных=SetDeletionScheduleTagged
УстановитьРежимВыгрузкиДокументов=SetDocumentUploadMode
УстановитьРежимВыгрузкиСправочников=SetCatalogUploadMode
УстановитьРолиВПрофиле=SetRolesInProfile
УстановитьСочетаниеКлавишКомандыПереходаМеждуИзменениямиНастроек=SetKeyboardCommandTransitionBetweenSettingChanges
УстановитьСтраницуВводКодаАктивации=SetPageEnterActivationCode
УстановитьСтраницуВводСведений=SetEnterDetailsPage
УстановитьСтраницуВход=SetLoginPage
УстановитьСтраницуВыборВариантаРегистрации=SetSelectRegistrationOptionPage
УстановитьСтраницуВыгрузкиДанных=SetDataUploadPage
УстановитьСтраницуЗавершение=SetPageCompletion
УстановитьСтраницуОжидание=SetWaitingPage
УстановитьСтраницуПриветствие=SetWelcomePage
УстановитьСтраницуСопоставлениеПользователей=SetUserMappingPage
УстановитьСтраницуСпособПерехода=SetTransitionMethodPage
УстановитьТекстыПоясненийПоРегистрацииПриложения=SetTextsExplanationsByRegistrationApplication
УстановитьФорматЗначенийПоУмолчанию=SetFormatValuesDefault
УстановитьЧасовойПоясИБ=SetIBTimeZone
УстановитьШиринуПоЗаголовку=SetWidthByTitle
Установлен=Is_Specified
УстановленноеРасширение=InstalledExtension
УстановленОтборПоПрофилю=SetSelectionByProfile
УстановленыОтборы=FiltersEnabled
УстановленыРасширенияИзменяющиеСтруктуруДанных=InstalledExtensionsThatChangeDataStructure
УстаревшийПрограммныйИнтерфейс=OutdatedProgrammingInterface
УточнениеОшибки=RefinementErrors
УточненияСобытийНастроек=RefinementsEventSettings
УточнитьДатуИзменения=SpecifyChangeDate
УточнитьКлючНазначенияИспользования=RefineUseDestinationKey
УточнитьПризнакАвтоформированияОтчета=RefineReportAutoGenerationSign
УточнитьСвойстваГруппУзлаИерархииЭлементовФормыНастроек=RefinePropertiesGroupsNodeHierarchyElementsFormSettings
УточнитьСвойстваГруппыУзлаИерархииЭлементовФормыНастроек=RefinePropertiesGroupNodeHierarchyElementsFormSettings
УчитыватьРасширениеДанных=ConsiderDataExpansion
ФабрикаПоСхеме=FactoryByScheme
ФайлАрхиваДанных=DataArchiveFile
ФайлДанныхСодержитПоставляемыеРасширения=DataFileContainsSuppliedExtensions
ФайлЗаявленияНажатие=ApplicationFileClick
ФайлПриемник=FileDestination
ФайлыКартинка=FilesPicture
ФайлыКонфигурацииВыгруженыПриИзменении=ConfigurationFilesAreUnloadedWhenChanging
ФайлыПодсистем=SubsystemFiles
ФайлыПредставление=FilesPresentation
ФайлыРезервныхКопий=BackupFiles
ФЗ=FederalLaw
ФиктивныйПользователь=DummyUser
ФлагХранитьИсториюИзменений=FlagKeepHistoryChanges
ФлажокХранилищаВариантов=OptionStorageCheckbox
ФормаВыбрать=FormSelect
ФормаВыбратьОтмеченные=FormSelectWithMark
ФормаВыгрузитьСертификат=FormExportCertificate
ФормаВыполнитьВыборРезультатаЗапроса=RequestResultSelectionForm
ФормаВыполнитьЗамер=FormToPerformMeasurement
ФормаГруппаУдаляемыеОбъекты=ShapeGroupRemovableObjects
ФормаДобавитьВРезультатВыгрузки=AddToUploadResultForm
ФормаЗакончитьРедактирование=FormEndEdit
ФормаЗаписатьГраницу=WriteBorderForm
ФормаЗаполнитьИзXML=FillOutTheFormFromXML
ФормаЗаполнитьПараметры=FillInTheParametersForm
ФормаЗапуститьРегламентноеЗадание=FormRunRegulatoryTask
ФормаМиграции=FormOfMigration
ФормаНаписатьПисьмо=WriteALetterForm
ФормаНастроитьДополнительно=ConfigureAdditionalForm
ФормаНастройки=FormSettings
ФормаОткрытьСписокПредупреждений=OpenWarningListForm
ФормаПараметрыОтбор=FormParametersSelection
ФормаПеренести=FormMoveTo_
ФормаПускБезКонтроля=FormStartWithoutControl
ФормаРазрешитьЗапретитьРедактирование=AllowProhibitEditingForm
ФормаРазрешитьРедактирование=FormEnableEdit
ФормаРассчитатьЗначение=CalculateValueForm
ФормаСоздатьПапку=FormCreateCatalog
ФормаСоздатьФайлыДляПереноса=CreateFilesToTransferForm
ФормаСравнитьРезультатыЗапросов=CompareQueryResultsForm
ФормаСформироватьФайлНастроек=FormToFormASettingsFile
ФорматИмени=NameFormat
ФорматИмениВыбранный=NameFormatSelected
ФорматированныйСписок=FormattedList
ФорматироватьЧисла=FormatNumbers
ФорматПоля=FormatFields
ФорматПоУмолчанию=DefaultFormat
ФормулыИзТекста=FormulasFromText
ФормыМультиязычныхОбъектов=FormsOfMultilingualObjects
ФормыНемультиязычныхОбъектов=FormsOfNonCulturalObjects
ФорумНажатие=ForumClick
ФрагментДоЗапроса=FragmentBeforeRequest
ФрагментЗапросаЭлементаОтбора=SelectionElementRequestFragment
ФрагментПослеЗапроса=FragmentAfterRequest
ХарактеристикиЗаданыКорректно=CharacteristicsAreSetCorrectly
ХешИмениКомпьютера=ComputerNameHash
ХешСуммаCRC32=CRC32HashSum
ХешСуммаВозможныхПрав=HashSumPossiblePermissions
ХешСуммаВременногоФайлаСовпадает=HashAmountOfTemporaryFileMatches
ХешСуммаДанных=HashAmountsData
ХешСуммаИсточника=HashSumOfSource
ХешСуммаПараметров=HashSumOfParameters
ХешСуммаПоставляемыхПрофилей=HashSumProfilesSupplied
ХешСуммаСтандартныхРолейРасширений=HashSumStandardRolesExtensions
ХешСуммаТиповГруппИЗначенийДоступа=HashSumGroupTypesFromAccessValues
ХешСуммы=HashAmounts
ХешСуммыСвойствВидовДоступа=HashSumAccessTypeProperties
ХозяйственнаяОперацияПриИзменении=BusinessOperationOnChange
ХранимоеЗначение=StoredValue
ХранимоеЗначениеВзаимодействия=StoredInteractionValue
ХранитьИсториюПриИзменении=StoreHistoryWhenChangesAreMade
ЦветВыбран=ColorSelected
ЦветНеВыбран=ColorNotSelected
ЦветНеДоступен=ColorNotAvailable
ЦветПравоВычисленное=ColorRightComputed
ЦветПравоЗапрещено=ColorRightForbidden
ЦветПравоНеНазначено=ColorRightNotAssigned
ЦветПравоРазрешено=ColorRightAllowed
ЦентрИдейНажатие=IdeasCenterClick
ЧасовойПоясПриложения=ApplicationTimeZone
Частей=Parts_
ЧастиЗаголовка=HeaderParts
ЧастиЗначенияДаты=PartsOfDateValue
ЧастиИсключения=PartsExceptions
ЧастиПредставления=PresentationParts
ЧастиПутиКОбъекту=PartsPathToObject
ЧастиТекстаОшибки=PartsOfErrorText
ЧастиТекстаПредупреждения=PartsOfWarningText
ЧастиТекстаСообщенияПользователям=PartsOfMessageTextToUsers
Частное=Quotient
ЧастьКодаВИБ=PartOfVIBCode
ЧастьКодаИБ=PartOfIBCode
ЧастьПолногоИмениОбъектаМетаданных=PartOfMetadataObjectSFullName
Чисел=Numbers_
ЧислоA=NumberA
ЧислоB=NumberB
ЧислоK=NumberK
ЧислоИзШестнадцатиричногоПредставления=NumberFromHexadecimalPresentation_
ЧислоЦифр=NumberDigits
ЧислоЦифрДляОбъектов=NumberDigitsForObjects
ЧитаемыеОбъект=ReadableObject
ЧтениеJSONПрочитать=ReadingJSONRead
ЧтениеДанныхАрхива=ReadingArchiveData
ЧтениеИсторииДанных=ReadHistoryData
ЧтениеИсторииДанныхОтсутствующихДанных=ReadHistoryDataMissingData
ЧтениеФайлаПользовательскихРасширений=ReadingCustomExtensionFile
Чтения=Reads
ШаблонURL=URLTemplate
ШаблонАдресаСтраницы=PageAddressTemplate
ШаблонДанныхОтвета=ResponseDataTemplate
ШаблонЗаписиВЖурнал=TemplateEntryToLog
ШаблонЗапросаДата=RequestTemplateDate
ШаблонМакетаПраваПоРоли=RoleRightsTemplate
ШаблонМакетаПраваПоЭталонуРоли=TemplateForTemplateRightsByRoleReference
ШаблонОписанияОшибкиВыгрузкиДанных=DataUploadErrorDescriptionTemplate
ШаблонПараметровЗапросов=TemplateForQueryParameters
ШаблонПараметровОжидания=WaitingParametersTemplate
ШаблонПолейВыборки=SelectionFieldTemplate
ШаблонПолейЗапроса=RequestFieldLayout
ШаблонПутиКФайлуМодуляКомандыОбъекта=ObjectCommandModuleFilePathTemplate
ШаблонПутиКФайлуМодуляОбщейКоманды=CommonCommandModuleFilePathTemplate
ШаблонПутиКФайлуОбщегоМодуля=CommonModuleFilePathTemplate
ШаблонСообщенияHTML=TemplateMessageHTML
ШаблонТекстаВТехПоддержку=TextTemplateInTech
ШаблонТекстаЗапросаПроверкаДублированияИзмерений=QueryTextTemplateCheckingForDuplicateDimensions
ШаблонТекстаЗапросаПроверкаРегистратора=RequestTextTemplateCheckLogger
ШаблонФрагментаЗапроса=RequestFragmentTemplate
Шаг1ВыборСпособаСравненияВерсий=Step1ChooseVersionComparisonMethod
Шаг2ПолучитьДанныеФайлов=Step2GetDataFiles
Шаг3ПолучитьПервыйФайл=Step3GetFirstFile
Шаг4ПолучитьВторойФайл=Step4GetSecondFile
Шаг5СравнитьФайлы=Step5CompareFiles
ШапкаОписанияОшибки=HeaderDescriptionErrors
ШестнадцатиричноеПредставлениеЧисла=HexadecimalPresentationOfNumber
ШиринаОбласти=AreaWidth
ШифрованиеКодаПользователя_СлужебныеПроцедурыИФункции=UserCodeEncryption_ServiceProceduresAndFunctions
ШифрованиеКодаПользователя_СлужебныйПрограммныйИнтерфейс=UserCodeEncryption_ServiceProgrammingInterface
ШрифтПравоЗапрещено=FontRightForbidden
ШрифтПравоНеНазначено=FontRightNotAssigned
ШрифтПравоРазрешено=FontRightAllowed
шт=PCs
ШтрихкодПриИзменении=BarcodeOnChange
ЭлектроннаяПочтаДляПаролейИзменениеТекстаРедактирования=EmailForPasswordsEditTextChange
ЭлектроннаяПочтаДляПаролейПриИзменении=EmailForPasswordsOnChange
ЭлектроннаяПочтаИзменениеТекстаРедактирования=EmailChangingTheEditingText
ЭлектроннаяПочтаПриИзменении=EmailAtTimeOfChange
ЭлектронныеПодписиПродлитьДействиеПодписей=DigitalSignaturesExtendActionSignatures
Элем=Ale
ЭлементВзаимодействия=InteractionElement
ЭлементКоманды=CommandElement
ЭлементКомпоновки=LayoutItem
ЭлементМетаданные=MetadataElement
ЭлементНадписьОшибка=ElementInscriptionError
ЭлементОграничениеПоВладельцу=OwnerRestrictionElement
ЭлементОформленияТекст=ElementDesignText
ЭлементПолныйАрхив=FullArchiveElement
ЭлементФайлПользовательскихРасширений=UserExtensionFileElement
ЭлементФайлПользовательскогоРасширения=UserExtensionFileElement_
ЭлементыАвторизации=AuthorizationElements
Эталон=Etalon
ЭтоВладелецНастроек=ThisSettingsOwner
ЭтоИндивидуальныйПредприниматель=ThisIsIndividualEntrepreneur
ЭтоИсключаемыйТип=ThisIsExcludedType
ЭтоКомандаРазблокировкиОбъекта=ThisObjectUnlockCommand
ЭтоМодельСервисаСДоступнымУсовершенствованием=ThisistheServiceModelwithEnhancementAvailable
ЭтоМультиязычныйОбъект=ItIsMultilingualFacility
ЭтоНаборПрав=ThisPermissionSet
ЭтоОбменДаннымиВМоделиСервиса=ThisDataExchangeInServiceModel
ЭтоОбъектСоСкрытымиПерсональнымиДанными=ThisIsObjectWithHiddenPersonalData
ЭтоОперацияВСервисе=ThisOperationInService
ЭтоОтборОбработчикаРасшифровкиПоДетальнымЗаписям=ThisSelectionDecipherHandlerByDetailedRecords
ЭтоОчисткаВыбранныхКлючей=ThisIsClearingSelectedKeys
ЭтоОшибкаТребованияПерезапускаСеанса=ThisErrorRequirementRestartSession
ЭтоОшибкаУсовершенствования=ThisisaBugImprovements
ЭтоПерерасчет=This_Is_Recalculation
ЭтоПечатнаяФормаСКД=ThisPrintableFormSKD
ЭтоПолеТабличнойЧасти=ThisTableSectionField
ЭтоПользовательскоеПолеВыражениеКомпоновкиДанных=ThisIsCustomDataLayoutExpressionField
ЭтоПредопределенныеДанные=ThisIsPredefinedData
ЭтоПредопределенныеПрисоединенныеФайлы=TheseArePredefinedAttachedFiles
ЭтоПрисоединенныйФайл=ThisisAttachedFile
ЭтоПроверкаПодписи=ThisVerificationSignature
ЭтоПродолжениеЗагрузки=ThisIsContinuationOfDownload
ЭтоРодительскаяПодсистема=ThisParentSubsystem
ЭтоСеансФоновогоЗадания=ThisBackgroundJobSession
ЭтоСимволИмениПеременной=ItSymbolNameVariable
ЭтоСохранениеФайла=ThisIsSavingFile
ЭтоТаблица=ThisIsTable
ЭтотУзелСсылка=ThisNodeLink
ЭтоФизическоеЛицо=ThisIsAnIndividual
ЭтоФИО=ThisIsTheFullName
ЭтоФормаОтчета=ThisReportForm
ЭтоЧастьПути=ThisPartPath
ЭтоЧитатель=ThisIsReader
ЭтоЧитатель2=ThisIsReader2
ЭтоЯчейкаЗаголовкаОтчета=ThisReportHeaderCell
ЮридическийАдрес=LegalAddress
ЮридическийАдресОрганизации=LegalAddressOrganization
ЮридическийАдресОрганизацииОбъект=LegalAddressOfOrganizationItem
ЯзыковыеПоля=LanguageFields
ЯзыкПереводаОчистка=TranslationLanguageCleaning
ЯзыкПереводаПриИзменении=TranslationLanguageWhenChanging
ЯзыкСинонима=SynonymLanguage
*КонтрольнаяСумма=Checksum
*ИдентификаторФайла=FileId
*Размер=Size
*Идентификатор=ID
*ДатаПо=DateBy
*ОписаниеВерсии=VersionDescription
*ДатаС=DateFrom
*Версия=Version
*АдресФайла=FileAddress
